,Entity,Code,Year,Mental_Disorders,Anxiety,Bipolar,Depression,ABD_Total,ABD_Percentage
0,Afghanistan,AFG,1990,1703785,486787,65942,439837,992566,0.5825652884606919
1,Afghanistan,AFG,2019,5881346,1717115,221643,1435039,3373797,0.5736436863262253
2,Afghanistan,AFG,2018,5689403,1652037,213864,1382786,3248687,0.5710066592224176
3,Afghanistan,AFG,2017,5510364,1594025,206279,1332807,3133111,0.5685851243220956
4,Afghanistan,AFG,2016,5332320,1538967,198352,1283786,3021105,0.5665648348186155
5,Afghanistan,AFG,2015,5169607,1485973,190872,1238345,2915190,0.5639094035581428
6,Afghanistan,AFG,2014,5051968,1441803,185239,1201934,2828976,0.5599750433890318
7,Afghanistan,AFG,2013,4938827,1394572,179581,1165521,2739674,0.5547215968488064
8,Afghanistan,AFG,2012,4786380,1335188,172223,1119167,2626578,0.5487608589372344
9,Afghanistan,AFG,2010,4479431,1220429,157160,1025343,2402932,0.5364368822736638
10,Afghanistan,AFG,2009,4330314,1167056,149817,980619,2297492,0.5305601395187508
11,Afghanistan,AFG,2008,4211454,1121083,143618,943571,2208272,0.5243490727905374
12,Afghanistan,AFG,2007,4083849,1073497,137175,905474,2116146,0.5181743987106281
13,Afghanistan,AFG,2006,3971211,1032175,131657,871872,2035704,0.5126154213412483
14,Afghanistan,AFG,2005,3886570,1001862,127889,848531,1978282,0.50900459788451
15,Afghanistan,AFG,2011,4632218,1276328,164689,1071820,2512837,0.5424695038100539
16,Afghanistan,AFG,2003,3596027,916133,117446,783016,1816595,0.5051672303906506
17,Afghanistan,AFG,2004,3744177,959333,122620,815634,1897587,0.5068101748394908
18,Afghanistan,AFG,1992,2184467,609249,83887,545449,1238585,0.5669964343704894
19,Afghanistan,AFG,1993,2409979,662644,91651,593044,1347339,0.5590666972616773
20,Afghanistan,AFG,1994,2531751,685973,94672,613915,1394560,0.5508282607570808
21,Afghanistan,AFG,1995,2657489,709523,97479,634196,1441198,0.5423156972615879
22,Afghanistan,AFG,1996,2792222,733618,100147,654394,1488159,0.5329658601644138
23,Afghanistan,AFG,1991,1884659,532646,72660,478890,1084196,0.5752743599770569
24,Afghanistan,AFG,1998,3003624,765143,102387,677690,1545220,0.5144518754677683
25,Afghanistan,AFG,1999,3040971,767532,101335,675439,1544306,0.5078331888071277
26,Afghanistan,AFG,2000,3094847,779133,101596,680803,1561532,0.5045587067793659
27,Afghanistan,AFG,2001,3225221,814165,105280,705861,1625306,0.5039363194026084
28,Afghanistan,AFG,2002,3432238,869933,111989,748661,1730583,0.5042141599737547
29,Afghanistan,AFG,1997,2923639,755530,102262,671950,1529742,0.5232321774336709
30,African Region (WHO),,2007,85777628,24748087,3767191,27411404,55926682,0.6519961358689005
31,African Region (WHO),,2008,87868050,25522198,3873986,27953405,57349589,0.652678521942845
32,African Region (WHO),,2009,90018792,26313060,3984366,28517801,58815227,0.6533660993806716
33,African Region (WHO),,2010,92254356,27087824,4098105,29152819,60338748,0.6540476852930391
34,African Region (WHO),,2012,96806843,28634167,4334973,30537401,63506541,0.6560129328873993
35,African Region (WHO),,2013,99133551,29440617,4458453,31268559,65167629,0.6573720838467695
36,African Region (WHO),,2016,107041927,32094783,4853275,34014776,70962834,0.6629442872417646
37,African Region (WHO),,2015,104200526,31148033,4716457,32982362,68846852,0.6607150140489694
38,African Region (WHO),,2017,110047999,33080784,4998214,35104296,73183294,0.665012491503821
39,African Region (WHO),,2018,113140228,34034775,5149614,36233907,75418296,0.6665913383169071
40,African Region (WHO),,2019,116292659,34961293,5306174,37412091,77679558,0.6679661353344755
41,African Region (WHO),,2006,83710140,24018077,3663891,26838965,54520933,0.6513061977915698
42,African Region (WHO),,2014,101576700,30276992,4585522,32070144,66932658,0.6589371184533461
43,African Region (WHO),,2005,81633828,23352628,3563436,26195223,53111287,0.6506039016080442
44,African Region (WHO),,2011,94524465,27850895,4214880,29839602,61905377,0.6549138045901661
45,African Region (WHO),,2003,77584406,22161322,3370158,24862326,50393806,0.6495352429455992
46,African Region (WHO),,1991,54818359,15802126,2371728,17355845,35529699,0.648135034469018
47,African Region (WHO),,1992,56365140,16231631,2438578,17808608,36478817,0.6471875524481976
48,African Region (WHO),,1993,57971321,16680494,2508507,18283977,37472978,0.6464054527927697
49,African Region (WHO),,1994,59738281,17175385,2585382,18819690,38580457,0.6458246932147244
50,African Region (WHO),,1995,61601841,17700410,2666739,19398364,39765513,0.6455247498203828
51,African Region (WHO),,1996,63573877,18247770,2751344,20052122,41051236,0.6457249099343115
52,African Region (WHO),,1990,53236901,15366495,2303911,16896232,34566638,0.6492984631092632
53,African Region (WHO),,2004,79580209,22742654,3465544,25517755,51725953,0.6499851363798252
54,African Region (WHO),,1998,67656176,19351575,2920732,21525137,43797444,0.6473532290681046
55,African Region (WHO),,1999,69698370,19906593,3006283,22262910,45175786,0.6481612984636513
56,African Region (WHO),,2000,71696196,20468350,3093979,22943251,46505580,0.6486478027369821
57,African Region (WHO),,2001,73656364,21031579,3184215,23579626,47795420,0.6488973580069741
58,African Region (WHO),,2002,75615952,21594500,3276474,24218944,49089918,0.6492005549305258
59,African Region (WHO),,1997,65616131,18801072,2836306,20779017,42416395,0.6464324298547868
60,Albania,ALB,2006,339704,116454,16990,77073,210517,0.6197071568188776
61,Albania,ALB,2007,337580,116505,16998,77157,210660,0.6240298595888382
62,Albania,ALB,2008,335571,116645,17013,77241,210899,0.6284780270047173
63,Albania,ALB,2009,333535,116761,17028,77346,211135,0.6330220216768855
64,Albania,ALB,2010,331726,116871,17053,77595,211519,0.6376316598638635
65,Albania,ALB,2011,330397,117063,17075,77919,212057,0.6418248349712619
66,Albania,ALB,2019,316139,115859,16696,79363,211918,0.6703317211732813
67,Albania,ALB,2013,326273,117085,17008,78237,212330,0.6507740450481652
68,Albania,ALB,2014,323627,116797,16925,78204,211926,0.6548464744906946
69,Albania,ALB,2016,320916,116511,16895,78655,212061,0.6607990876117115
70,Albania,ALB,2017,318721,115934,16831,78768,211533,0.6636933242553832
71,Albania,ALB,2018,317090,115715,16764,78984,211463,0.666886372954051
72,Albania,ALB,2005,342097,116581,16993,76933,210507,0.6153430167467122
73,Albania,ALB,2012,328819,117233,17072,78172,212477,0.6461822461597414
74,Albania,ALB,2015,322285,116778,16910,78435,212123,0.6581845261181873
75,Albania,ALB,2004,344627,116837,17006,76765,210608,0.6111186877406587
76,Albania,ALB,2002,349138,117227,17036,76141,210404,0.6026384982442473
77,Albania,ALB,2003,347005,117077,17022,76480,210579,0.6068471635855391
78,Albania,ALB,1990,350242,114729,16781,70408,201918,0.5765099559732985
79,Albania,ALB,1991,354314,115841,16940,71245,204026,0.5758338648769171
80,Albania,ALB,1992,357438,116750,17064,71961,205775,0.5756942462748784
81,Albania,ALB,1994,361287,118077,17232,73195,208504,0.5771145931074187
82,Albania,ALB,1995,361863,118461,17273,73658,209392,0.5786499310512542
83,Albania,ALB,1993,359777,117488,17160,72623,207271,0.5761096456971958
84,Albania,ALB,1997,373204,122724,17918,77091,217733,0.5834155046569705
85,Albania,ALB,1998,383076,126254,18471,79776,224501,0.5860481993129301
86,Albania,ALB,1999,367589,121750,17748,77570,217068,0.5905182146364554
87,Albania,ALB,2000,353625,117700,17104,75580,210384,0.5949353128313892
88,Albania,ALB,2001,351262,117419,17061,75797,210277,0.5986329292664735
89,Albania,ALB,1996,362086,118843,17316,74251,210410,0.5811050413437692
90,Algeria,DZA,2011,5195953,1773690,289424,1479597,3542711,0.681821217397463
91,Algeria,DZA,2007,4918230,1676456,267991,1369394,3313841,0.673787317795223
92,Algeria,DZA,2008,4983477,1701033,273689,1394114,3368836,0.6760011132789416
93,Algeria,DZA,2009,5050241,1724968,279156,1420041,3424165,0.6780201182478223
94,Algeria,DZA,2010,5121070,1748624,284401,1448602,3481627,0.6798631926530979
95,Algeria,DZA,2013,5359273,1829827,298851,1545091,3673769,0.6854976411912586
96,Algeria,DZA,2006,4850744,1651079,262080,1343304,3256463,0.6713326862848256
97,Algeria,DZA,2015,5525580,1887177,307608,1607687,3802472,0.6881579852250804
98,Algeria,DZA,2016,5603847,1915304,311880,1634420,3861604,0.6890987566220134
99,Algeria,DZA,2017,5685172,1944350,316153,1661264,3921767,0.6898238083210148
100,Algeria,DZA,2018,5781481,1977480,320461,1699104,3997045,0.6913531325278073
101,Algeria,DZA,2019,5890019,2015957,324847,1747189,4087993,0.6940542976177156
102,Algeria,DZA,2014,5443382,1858916,303284,1577918,3740118,0.6870945305694144
103,Algeria,DZA,2005,4779715,1624767,255985,1313898,3194650,0.6683766709939819
104,Algeria,DZA,2012,5275734,1801067,294236,1511925,3607228,0.6837395516908169
105,Algeria,DZA,2003,4634264,1566996,243391,1253434,3063821,0.6611235354740257
106,Algeria,DZA,1990,3348264,1109981,161965,855650,2127596,0.6354325704305276
107,Algeria,DZA,1991,3460260,1146705,167654,882669,2197028,0.6349314791374059
108,Algeria,DZA,1992,3570993,1183901,173459,909815,2267175,0.6348864307490941
109,Algeria,DZA,1993,3682459,1221287,179400,938305,2338992,0.635171226617866
110,Algeria,DZA,1994,3791211,1258533,185465,967894,2411892,0.6361798380517465
111,Algeria,DZA,1995,3897029,1295454,191653,998317,2485424,0.6377740581350562
112,Algeria,DZA,1996,4001176,1332192,197969,1029354,2559515,0.6396906809398037
113,Algeria,DZA,2004,4707230,1596806,249742,1283919,3130467,0.665033788448833
114,Algeria,DZA,1997,4102346,1368607,204377,1061318,2634302,0.6421452505468822
115,Algeria,DZA,1998,4201042,1404171,210849,1093047,2708067,0.6446179305039084
116,Algeria,DZA,1999,4297298,1438544,217354,1125919,2781817,0.6473409570385856
117,Algeria,DZA,2000,4390061,1471559,223883,1158584,2854026,0.6501107843376208
118,Algeria,DZA,2001,4477081,1503825,230419,1190591,2924835,0.6532906150234941
119,Algeria,DZA,2002,4557493,1535826,236936,1222046,2994808,0.657117410822134
120,American Samoa,ASM,2007,5867,2174,145,1334,3653,0.6226350775524118
121,American Samoa,ASM,2008,5869,2182,145,1334,3661,0.6237859942068495
122,American Samoa,ASM,2010,5870,2195,146,1337,3678,0.6265758091993185
123,American Samoa,ASM,2011,5878,2202,146,1343,3691,0.6279346716570262
124,American Samoa,ASM,2012,5889,2211,147,1351,3709,0.629818305314994
125,American Samoa,ASM,2013,5901,2221,147,1360,3728,0.6317573292662261
126,American Samoa,ASM,2016,5921,2236,150,1388,3774,0.6373923323762878
127,American Samoa,ASM,2015,5921,2237,149,1380,3766,0.6360412092551934
128,American Samoa,ASM,2006,5867,2167,145,1334,3646,0.6214419635247997
129,American Samoa,ASM,2017,5922,2236,151,1397,3784,0.6389733198243837
130,American Samoa,ASM,2018,5938,2245,152,1412,3809,0.641461771640283
131,American Samoa,ASM,2019,5964,2261,153,1433,3847,0.6450368879946344
132,American Samoa,ASM,2014,5913,2230,148,1371,3749,0.6340267207847117
133,American Samoa,ASM,2005,5865,2164,145,1332,3641,0.6208013640238704
134,American Samoa,ASM,2009,5870,2189,146,1335,3670,0.6252129471890971
135,American Samoa,ASM,2003,5862,2164,145,1327,3636,0.6202661207778914
136,American Samoa,ASM,1991,4851,1790,119,1089,2998,0.6180169037311894
137,American Samoa,ASM,1992,5002,1845,123,1122,3090,0.6177528988404638
138,American Samoa,ASM,1993,5144,1897,126,1153,3176,0.6174183514774495
139,American Samoa,ASM,1994,5275,1945,130,1181,3256,0.6172511848341232
140,American Samoa,ASM,1995,5394,1989,133,1208,3330,0.6173526140155728
141,American Samoa,ASM,1996,5502,2030,135,1233,3398,0.6175936023264268
142,American Samoa,ASM,1990,4692,1733,115,1054,2902,0.6184995737425405
143,American Samoa,ASM,1998,5678,2099,140,1274,3513,0.6187037689327228
144,American Samoa,ASM,1997,5597,2067,138,1255,3460,0.6181883151688404
145,American Samoa,ASM,2002,5853,2164,145,1323,3632,0.6205364770203314
146,American Samoa,ASM,2001,5831,2159,144,1315,3618,0.6204767621334248
147,American Samoa,ASM,2004,5866,2163,145,1330,3638,0.6201841118308898
148,American Samoa,ASM,1999,5744,2126,142,1290,3558,0.6194289693593314
149,American Samoa,ASM,2000,5797,2147,143,1304,3594,0.6199758495773676
150,Andorra,AND,2019,12677,4868,923,3683,9474,0.7473376981935789
151,Andorra,AND,2006,12122,4633,879,3401,8913,0.7352747071440356
152,Andorra,AND,2007,12406,4737,900,3484,9121,0.7352087699500242
153,Andorra,AND,2008,12581,4803,915,3539,9257,0.7357920674032271
154,Andorra,AND,2009,12531,4786,912,3534,9232,0.7367329024020429
155,Andorra,AND,2010,12559,4798,914,3550,9262,0.7374790986543515
156,Andorra,AND,2011,11717,4492,847,3304,8643,0.7376461551591704
157,Andorra,AND,2012,11435,4389,825,3231,8445,0.7385220813292523
158,Andorra,AND,2014,11571,4451,835,3290,8576,0.7411632529599862
159,Andorra,AND,2016,11816,4548,854,3372,8774,0.742552471225457
160,Andorra,AND,2017,12103,4659,878,3464,9001,0.743699909113443
161,Andorra,AND,2018,12394,4768,901,3567,9236,0.7451992899790221
162,Andorra,AND,2005,11744,4492,851,3297,8640,0.7356948228882834
163,Andorra,AND,2013,11425,4391,824,3239,8454,0.7399562363238512
164,Andorra,AND,2015,11733,4516,847,3344,8707,0.7420949458791443
165,Andorra,AND,2004,11458,4380,831,3225,8436,0.736254145575144
166,Andorra,AND,2002,10020,3827,724,2840,7391,0.737624750499002
167,Andorra,AND,1990,8179,3102,578,2258,5938,0.7260056241594327
168,Andorra,AND,1991,8862,3367,630,2448,6445,0.7272624689686301
169,Andorra,AND,1992,9277,3533,662,2568,6763,0.7290072221623369
170,Andorra,AND,1993,9774,3720,699,2715,7134,0.7298956414978515
171,Andorra,AND,1994,9678,3690,694,2697,7081,0.7316594337673072
172,Andorra,AND,1995,9591,3659,689,2681,7029,0.73287456990929
173,Andorra,AND,2003,10771,4115,780,3044,7939,0.7370717667811717
174,Andorra,AND,1997,9784,3733,704,2746,7183,0.7341578086672118
175,Andorra,AND,1998,9858,3762,710,2771,7243,0.734733211604788
176,Andorra,AND,1999,9848,3758,710,2774,7242,0.7353777416734363
177,Andorra,AND,2000,9812,3745,707,2771,7223,0.7361394211169996
178,Andorra,AND,2001,9870,3767,712,2795,7274,0.7369807497467072
179,Andorra,AND,1996,9671,3692,695,2709,7096,0.7337400475648848
180,Angola,AGO,2007,2118951,645953,82570,800320,1528843,0.7215093694946225
181,Angola,AGO,2008,2190168,670511,85768,828054,1584333,0.7233842335382491
182,Angola,AGO,2009,2264813,696061,89081,857163,1642305,0.7251393382146782
183,Angola,AGO,2010,2345546,722837,92507,888628,1703972,0.7264713631708779
184,Angola,AGO,2011,2431920,750759,96055,922801,1769615,0.727661682950097
185,Angola,AGO,2012,2522064,779659,99730,957843,1837232,0.7284636710250018
186,Angola,AGO,2015,2821016,874098,111633,1073701,2059432,0.7300320168336514
187,Angola,AGO,2014,2715439,841150,107511,1033233,1981894,0.7298613594339626
188,Angola,AGO,2016,2931357,908096,115916,1116039,2140051,0.7300547152735064
189,Angola,AGO,2017,3045515,943097,120377,1159979,2223453,0.7300745522514255
190,Angola,AGO,2018,3160820,977650,125042,1203809,2306501,0.7297160230573079
191,Angola,AGO,2006,2048406,622195,79485,773256,1474936,0.7200408512765536
192,Angola,AGO,2013,2615649,809715,103542,994528,1907785,0.7293734748049145
193,Angola,AGO,2019,3276493,1010969,129934,1247865,2388768,0.729062445730847
194,Angola,AGO,2005,1978634,599061,76511,746581,1422153,0.7187549592294482
195,Angola,AGO,2003,1844051,554433,70880,696859,1322172,0.7169931851125593
196,Angola,AGO,2004,1909882,576450,73645,721091,1371186,0.7179427838997383
197,Angola,AGO,1990,1158527,344386,44593,447627,836606,0.7221290483519158
198,Angola,AGO,1991,1200631,356609,46117,462958,865684,0.7210241947775795
199,Angola,AGO,1992,1244437,369419,47718,478923,896060,0.720052521742764
200,Angola,AGO,1994,1335640,396358,51074,512106,959538,0.7184106495762331
201,Angola,AGO,1995,1384457,410917,52893,530312,994122,0.7180591379869509
202,Angola,AGO,1993,1289248,382609,49363,495152,927124,0.7191199831219439
203,Angola,AGO,1997,1487827,442140,56801,568092,1067033,0.7171754511781275
204,Angola,AGO,1998,1541398,458559,58855,587044,1104458,0.7165300590762412
205,Angola,AGO,1999,1597523,475670,60998,607471,1144139,0.7161956353680041
206,Angola,AGO,2000,1656450,493756,63280,628765,1185801,0.7158688762111745
207,Angola,AGO,2001,1717072,512901,65687,651092,1229680,0.7161493519200127
208,Angola,AGO,2002,1779721,533175,68222,673560,1274957,0.7163802640975748
209,Angola,AGO,1996,1435287,426201,54806,548960,1029967,0.7176035176240013
210,Antigua and Barbuda,ATG,2011,12059,3960,890,2638,7488,0.6209470105315532
211,Antigua and Barbuda,ATG,2007,11703,3788,854,2557,7199,0.6151414167307528
212,Antigua and Barbuda,ATG,2008,11796,3837,864,2567,7268,0.6161410647677179
213,Antigua and Barbuda,ATG,2009,11883,3881,873,2579,7333,0.6171000589076833
214,Antigua and Barbuda,ATG,2010,11968,3921,882,2601,7404,0.6186497326203209
215,Antigua and Barbuda,ATG,2012,12157,4002,898,2685,7585,0.6239203750925393
216,Antigua and Barbuda,ATG,2006,11590,3735,843,2541,7119,0.6142364106988784
217,Antigua and Barbuda,ATG,2014,12344,4084,914,2782,7780,0.6302657161373947
218,Antigua and Barbuda,ATG,2015,12417,4116,921,2822,7859,0.6329226061045341
219,Antigua and Barbuda,ATG,2016,12470,4138,927,2853,7918,0.6349639133921411
220,Antigua and Barbuda,ATG,2017,12515,4158,933,2885,7976,0.6373152217339193
221,Antigua and Barbuda,ATG,2018,12594,4180,938,2951,8069,0.6407019215499444
222,Antigua and Barbuda,ATG,2019,12700,4204,943,3056,8203,0.6459055118110236
223,Antigua and Barbuda,ATG,2013,12253,4045,906,2734,7685,0.627193340406431
224,Antigua and Barbuda,ATG,2005,11447,3680,831,2509,7020,0.6132611164497248
225,Antigua and Barbuda,ATG,1997,9502,3019,678,2012,5709,0.6008208798147758
226,Antigua and Barbuda,ATG,2003,11093,3559,802,2415,6776,0.6108356621292708
227,Antigua and Barbuda,ATG,1990,8130,2536,560,1735,4831,0.5942189421894218
228,Antigua and Barbuda,ATG,1991,8224,2572,570,1745,4887,0.5942363813229572
229,Antigua and Barbuda,ATG,1992,8357,2621,583,1765,4969,0.5945913605360775
230,Antigua and Barbuda,ATG,1993,8527,2682,599,1794,5075,0.5951682889644658
231,Antigua and Barbuda,ATG,1995,8959,2833,635,1884,5352,0.5973881013505972
232,Antigua and Barbuda,ATG,1996,9222,2923,656,1945,5524,0.599002385599653
233,Antigua and Barbuda,ATG,1994,8727,2752,616,1833,5201,0.595966540621061
234,Antigua and Barbuda,ATG,1998,9794,3119,700,2084,5903,0.6027159485399224
235,Antigua and Barbuda,ATG,1999,10087,3221,723,2158,6102,0.6049370476851393
236,Antigua and Barbuda,ATG,2000,10371,3318,745,2228,6291,0.6065953138559445
237,Antigua and Barbuda,ATG,2001,10639,3408,766,2295,6469,0.6080458689726478
238,Antigua and Barbuda,ATG,2002,10879,3488,784,2358,6630,0.6094310138799522
239,Antigua and Barbuda,ATG,2004,11284,3622,817,2466,6905,0.6119283941864587
240,Argentina,ARG,2011,5347450,2084813,446495,1042836,3574144,0.668382874080169
241,Argentina,ARG,2007,5173846,2024845,421339,1038445,3484629,0.6735084500002513
242,Argentina,ARG,2008,5197845,2027489,427628,1028172,3483289,0.6701409911222824
243,Argentina,ARG,2009,5230092,2035232,434049,1021998,3491279,0.6675368234440235
244,Argentina,ARG,2010,5282979,2055365,440363,1028143,3523871,0.6670234729307082
245,Argentina,ARG,2012,5411743,2115634,452564,1058037,3626235,0.6700678505982268
246,Argentina,ARG,2019,5865630,2329026,494127,1152193,3975346,0.6777355544076255
247,Argentina,ARG,2014,5545528,2180138,464907,1089314,3734359,0.6734000802087736
248,Argentina,ARG,2015,5612817,2211605,471055,1104941,3787601,0.6748128435329355
249,Argentina,ARG,2016,5680399,2244434,477125,1118441,3840000,0.6760088507867141
250,Argentina,ARG,2017,5744791,2275791,483037,1130769,3889597,0.6770650142015611
251,Argentina,ARG,2018,5807115,2303131,488654,1142816,3934601,0.6775483178824597
252,Argentina,ARG,2006,5146115,2018805,415145,1044267,3478217,0.6758918135331216
253,Argentina,ARG,2013,5478889,2147737,458687,1073939,3680363,0.67173527333735
254,Argentina,ARG,2005,5095773,2001028,409044,1038150,3448222,0.6766828114203675
255,Argentina,ARG,2004,5029505,1974759,400744,1023501,3399004,0.6758128284990272
256,Argentina,ARG,2003,4960128,1948632,389354,1008070,3346056,0.6745906557250135
257,Argentina,ARG,1991,4321843,1677964,320372,849178,2847514,0.6588656737415033
258,Argentina,ARG,1992,4373615,1698302,324719,862063,2885084,0.6596565998607559
259,Argentina,ARG,1993,4424339,1718653,329036,874894,2922583,0.6605694093513178
260,Argentina,ARG,1994,4473981,1739043,333370,888283,2960696,0.6617587334412015
261,Argentina,ARG,1995,4522216,1759986,337714,901212,2998912,0.6631509861536911
262,Argentina,ARG,1996,4572247,1782274,342029,914651,3038954,0.6646521939868952
263,Argentina,ARG,1990,4269240,1657663,315929,835664,2809256,0.6580225051765654
264,Argentina,ARG,1998,4671515,1829222,350580,939818,3119620,0.6677962074401987
265,Argentina,ARG,1999,4720588,1852511,354790,952319,3159620,0.669327634608231
266,Argentina,ARG,2000,4772379,1875373,359217,964959,3199549,0.6704306175180136
267,Argentina,ARG,2001,4830555,1898810,366378,978710,3243898,0.6715373285264322
268,Argentina,ARG,2002,4893243,1923318,377151,993531,3294000,0.6731731900500343
269,Argentina,ARG,1997,4621567,1805599,346322,927075,3078996,0.6662233826751836
270,Armenia,ARM,2008,358095,107170,19055,102407,228632,0.6384674457895251
271,Armenia,ARM,2009,354743,106445,19003,102474,227922,0.6424989358493332
272,Armenia,ARM,2010,351914,105776,18942,102699,227417,0.6462289081991623
273,Armenia,ARM,2011,349644,105196,18878,103074,227148,0.6496550777362117
274,Armenia,ARM,2012,347813,104694,18797,103554,227045,0.6527789358074597
275,Armenia,ARM,2013,346538,104283,18716,104072,227071,0.6552557006735192
276,Armenia,ARM,2016,343371,103142,18442,104663,226247,0.6588995576213483
277,Armenia,ARM,2015,344435,103568,18537,104628,226733,0.6582751462540102
278,Armenia,ARM,2017,342486,102770,18349,104585,225704,0.6590167189315768
279,Armenia,ARM,2018,342075,102603,18272,104864,225739,0.659910838266462
280,Armenia,ARM,2019,342130,102595,18199,105444,226238,0.6612632625025575
281,Armenia,ARM,2007,361564,107885,19093,102171,229149,0.6337716144306402
282,Armenia,ARM,2014,345448,103930,18630,104449,227009,0.6571437669345314
283,Armenia,ARM,2006,365158,108519,19118,101910,229547,0.6286237738184567
284,Armenia,ARM,2005,368370,109014,19111,101421,229546,0.6231397779406574
285,Armenia,ARM,1990,358219,103997,18258,91333,213588,0.5962497801624146
286,Armenia,ARM,1991,361203,104511,18314,91266,214091,0.5927165610473889
287,Armenia,ARM,1992,363890,104963,18354,91284,214601,0.5897414053697546
288,Armenia,ARM,1993,365985,105366,18385,91282,215033,0.5875459376750414
289,Armenia,ARM,1994,368139,105808,18426,91429,215663,0.5858194866612882
290,Armenia,ARM,1995,370135,106334,18476,91858,216668,0.5853756061977387
291,Armenia,ARM,1996,372145,106897,18539,92553,217989,0.5857636136452189
292,Armenia,ARM,2004,371458,109362,19092,100722,229176,0.6169634252055414
293,Armenia,ARM,1998,376045,108035,18682,94641,221358,0.5886476352564188
294,Armenia,ARM,1999,377499,108565,18779,95816,223160,0.5911538838513479
295,Armenia,ARM,2000,378469,109042,18875,97008,224925,0.5943023074545075
296,Armenia,ARM,2001,378503,109422,18964,98140,226526,0.5984787438937076
297,Armenia,ARM,2002,377090,109608,19021,99165,227794,0.6040839056989048
298,Armenia,ARM,2003,374467,109575,19062,100010,228647,0.610593189787084
299,Armenia,ARM,1997,374072,107473,18603,93510,219586,0.587015333946406
300,Australia,AUS,2007,3715190,1201789,248601,1079238,2529628,0.6808879222866125
301,Australia,AUS,2008,3759775,1219365,252252,1086839,2558456,0.6804811458132468
302,Australia,AUS,2009,3804067,1236979,256023,1094208,2587210,0.6801168328528389
303,Australia,AUS,2010,3851339,1253917,259933,1103593,2617443,0.6796189584972915
304,Australia,AUS,2011,3898552,1268516,263875,1113602,2645993,0.6787117370757143
305,Australia,AUS,2012,3946067,1281303,267871,1123217,2672391,0.677228997885743
306,Australia,AUS,2016,4151823,1382397,283881,1136582,2802860,0.6750913996092801
307,Australia,AUS,2014,4042211,1309675,275972,1141102,2726749,0.6745686952017101
308,Australia,AUS,2015,4093220,1328593,279972,1149604,2758169,0.6738384450383805
309,Australia,AUS,2017,4213378,1436697,287621,1126306,2850624,0.6765649794535405
310,Australia,AUS,2018,4270976,1456421,291242,1140467,2888130,0.6762224840411185
311,Australia,AUS,2019,4332635,1470726,294693,1160300,2925719,0.6752747461994837
312,Australia,AUS,2006,3670524,1184939,245040,1069268,2499247,0.6808965150479876
313,Australia,AUS,2013,3993992,1294484,271927,1132312,2698723,0.6756956448585776
314,Australia,AUS,2004,3563007,1145780,237904,1035050,2418734,0.6788462666506128
315,Australia,AUS,2000,3277157,1022597,224402,928811,2175810,0.6639321826815133
316,Australia,AUS,2003,3486270,1111881,234205,1007398,2353484,0.6750722118481931
317,Australia,AUS,1990,2999581,1017318,200845,793401,2011564,0.6706149958944266
318,Australia,AUS,1991,3028783,1014510,203480,810675,2028665,0.6697954260836778
319,Australia,AUS,1992,3055765,1011311,205982,827035,2044328,0.6690069426150244
320,Australia,AUS,1993,3081864,1008722,208314,842005,2059041,0.6681154651860043
321,Australia,AUS,2005,3623951,1169040,241543,1055981,2466564,0.6806284080551862
322,Australia,AUS,1995,3133940,1008711,212604,870041,2091356,0.6673248371060071
323,Australia,AUS,1994,3106635,1007444,210484,856224,2074152,0.667652299030945
324,Australia,AUS,1997,3182930,1009733,216956,891667,2118356,0.6655364711130939
325,Australia,AUS,1998,3208187,1010245,219303,901839,2131387,0.6643587172443501
326,Australia,AUS,1999,3238599,1013725,221766,913596,2149087,0.6635853960308146
327,Australia,AUS,2001,3332504,1043038,227317,950494,2220849,0.6664205054217489
328,Australia,AUS,2002,3406170,1075058,230618,978096,2283772,0.6704809213867775
329,Australia,AUS,1996,3159559,1010047,214738,881831,2106616,0.6667436816340508
330,Austria,AUT,2011,1265800,523543,87811,311397,922751,0.7289864117554116
331,Austria,AUT,2007,1254982,514882,86264,310796,911942,0.7266574341305294
332,Austria,AUT,2008,1257417,517641,86719,309922,914282,0.7271112129070945
333,Austria,AUT,2009,1259207,519791,87076,309308,916175,0.7275809299027086
334,Austria,AUT,2010,1261495,521458,87393,309753,918604,0.7281867942401674
335,Austria,AUT,2012,1272589,526858,88358,314112,929328,0.7302656238581349
336,Austria,AUT,2006,1251402,511736,85753,311706,909195,0.7265411114893535
337,Austria,AUT,2014,1293344,536336,89789,321009,947134,0.7323140633891679
338,Austria,AUT,2015,1305547,541652,90571,324348,956571,0.7326974823579695
339,Austria,AUT,2016,1317654,547857,91305,327142,966304,0.7333518510929273
340,Austria,AUT,2017,1327473,553077,91863,329455,974395,0.7340224622271037
341,Austria,AUT,2018,1335927,556707,92394,331896,980997,0.7343193153518119
342,Austria,AUT,2019,1344131,559733,92859,334514,987106,0.7343822886310932
343,Austria,AUT,2013,1282157,531228,89036,317487,937751,0.7313854699541475
344,Austria,AUT,2005,1246722,508463,85178,311974,905615,0.7263969032390541
345,Austria,AUT,1990,1193657,471043,79407,322772,873222,0.731551861213062
346,Austria,AUT,2003,1233637,500106,83804,312110,896020,0.7263238699876868
347,Austria,AUT,1991,1198049,474461,79629,323104,877194,0.7321854114481128
348,Austria,AUT,1992,1201293,477356,79797,322891,880044,0.7325806443557067
349,Austria,AUT,1993,1204387,479788,79953,322710,882451,0.7326972144335666
350,Austria,AUT,1994,1206715,481712,80116,322081,883909,0.7324919305718417
351,Austria,AUT,1995,1208874,483107,80291,321537,884935,0.7320324533408775
352,Austria,AUT,1996,1210721,484094,80556,320767,885417,0.7313138204425297
353,Austria,AUT,2004,1240469,504639,84523,311894,901056,0.7263833275962559
354,Austria,AUT,1998,1212367,485487,81199,316998,883684,0.7288914990262849
355,Austria,AUT,1999,1213705,486593,81580,315029,883202,0.7276908309679865
356,Austria,AUT,2000,1216554,488463,82000,313856,884319,0.7269048476269857
357,Austria,AUT,2001,1221240,491552,82506,313242,887300,0.7265566145884511
358,Austria,AUT,2002,1227106,495580,83113,312507,891200,0.726261626949913
359,Austria,AUT,1997,1211680,484752,80861,319099,884712,0.7301531757559752
360,Azerbaijan,AZE,2008,932203,239042,50590,242525,532157,0.5708595659958186
361,Azerbaijan,AZE,2009,936753,242436,51675,247164,541275,0.5778204073005371
362,Azerbaijan,AZE,2010,943825,245648,52709,252226,550583,0.5833528461314332
363,Azerbaijan,AZE,2011,953355,248573,53677,258203,560453,0.587874401455911
364,Azerbaijan,AZE,2012,963442,251157,54581,264511,570249,0.591887212722717
365,Azerbaijan,AZE,2013,973973,253562,55422,270830,579814,0.5953080834889674
366,Azerbaijan,AZE,2016,1007419,260338,57718,287008,605064,0.6006080885907452
367,Azerbaijan,AZE,2015,996792,258451,57005,282446,597902,0.5998262425862165
368,Azerbaijan,AZE,2017,1018348,262295,58394,291489,612178,0.6011481340366948
369,Azerbaijan,AZE,2018,1031270,265038,59037,297333,621408,0.6025657684214609
370,Azerbaijan,AZE,2019,1046156,268071,59673,304935,632679,0.6047654460711405
371,Azerbaijan,AZE,2007,928455,235604,49504,237953,523061,0.5633670991055032
372,Azerbaijan,AZE,2014,985588,255956,56233,277050,589239,0.5978552904459064
373,Azerbaijan,AZE,2006,923582,232004,48395,233341,513740,0.5562473066820272
374,Azerbaijan,AZE,2005,915841,228347,47295,228260,503902,0.5502068590508614
375,Azerbaijan,AZE,1990,703593,177344,36227,179433,393004,0.5585672398673664
376,Azerbaijan,AZE,2004,905680,224547,46214,222830,493591,0.5449949209433795
377,Azerbaijan,AZE,1991,715280,179961,36755,180692,397408,0.5555978078514707
378,Azerbaijan,AZE,1992,727282,182548,37261,181660,401469,0.5520128368363303
379,Azerbaijan,AZE,1993,739863,185187,37747,182925,405859,0.5485596657759613
380,Azerbaijan,AZE,1995,767749,190844,38786,186244,415874,0.5416796374856887
381,Azerbaijan,AZE,1996,784691,194083,39381,188798,422262,0.538125198326475
382,Azerbaijan,AZE,1994,753276,187927,38248,184419,410594,0.5450777669804958
383,Azerbaijan,AZE,1998,822806,201283,40725,194991,436999,0.5311081834600136
384,Azerbaijan,AZE,1999,841172,205110,41491,198645,445246,0.5293162397226726
385,Azerbaijan,AZE,2000,856624,208855,42309,202451,453615,0.5295380470311362
386,Azerbaijan,AZE,2001,870414,212757,43213,207078,463048,0.5319859285351568
387,Azerbaijan,AZE,2002,882900,216698,44169,212007,472874,0.5355917997508212
388,Azerbaijan,AZE,2003,894677,220648,45165,217326,483139,0.5400149998267532
389,Azerbaijan,AZE,1997,803544,197624,40038,191789,429451,0.5344461535398186
390,Bahamas,BHS,2011,49405,15981,3420,10824,30225,0.6117801841918834
391,Bahamas,BHS,2007,46903,14958,3218,10225,28401,0.6055262989574227
392,Bahamas,BHS,2008,47547,15233,3274,10349,28856,0.6068942309714598
393,Bahamas,BHS,2009,48182,15496,3325,10478,29299,0.6080901581503466
394,Bahamas,BHS,2010,48788,15738,3373,10635,29746,0.609699106337624
395,Bahamas,BHS,2012,50055,16243,3470,11058,30771,0.614743781839976
396,Bahamas,BHS,2006,46259,14691,3162,10088,27941,0.604012192222054
397,Bahamas,BHS,2014,51366,16776,3565,11538,31879,0.6206245376318966
398,Bahamas,BHS,2015,51941,17005,3607,11745,32357,0.6229568163878246
399,Bahamas,BHS,2016,52418,17209,3647,11910,32766,0.6250906177267351
400,Bahamas,BHS,2017,52849,17403,3687,12079,33169,0.6276183087664856
401,Bahamas,BHS,2018,53377,17595,3729,12369,33693,0.6312269329486483
402,Bahamas,BHS,2019,53986,17785,3768,12784,34337,0.6360352684029192
403,Bahamas,BHS,2013,50717,16515,3519,11303,31337,0.6178796064435987
404,Bahamas,BHS,2005,45603,14440,3108,9929,27477,0.6025261495954214
405,Bahamas,BHS,1990,34869,10770,2307,7304,20381,0.584501993174453
406,Bahamas,BHS,2003,44204,13959,3001,9564,26524,0.6000361958193828
407,Bahamas,BHS,2004,44932,14202,3055,9753,27010,0.6011305973471023
408,Bahamas,BHS,1991,35449,10970,2361,7419,20750,0.5853479646816553
409,Bahamas,BHS,1992,36038,11177,2414,7541,21132,0.5863810422331983
410,Bahamas,BHS,1993,36659,11391,2465,7672,21528,0.5872500613764696
411,Bahamas,BHS,1995,37997,11852,2568,7985,22405,0.5896518146169435
412,Bahamas,BHS,1996,38734,12104,2621,8170,22895,0.5910827696597305
413,Bahamas,BHS,1994,37299,11616,2516,7812,21944,0.5883267647926218
414,Bahamas,BHS,1998,40338,12653,2728,8578,23959,0.5939560711983738
415,Bahamas,BHS,1999,41131,12929,2782,8785,24496,0.5955605261238482
416,Bahamas,BHS,2000,41902,13193,2836,8991,25020,0.5971075366330962
417,Bahamas,BHS,2001,42661,13450,2890,9182,25522,0.5982513302547995
418,Bahamas,BHS,2002,43431,13705,2945,9375,26025,0.5992263590522898
419,Bahamas,BHS,1997,39513,12372,2674,8370,23416,0.5926150887049831
420,Bahrain,BHR,2011,197337,67988,11835,66908,146731,0.743555440692825
421,Bahrain,BHR,2007,156263,54030,9096,53187,116313,0.7443412708062689
422,Bahrain,BHR,2008,168351,58233,9907,57119,125259,0.7440347844681647
423,Bahrain,BHR,2009,180758,62506,10739,61159,134404,0.7435576848604211
424,Bahrain,BHR,2010,191078,65988,11428,64656,142072,0.7435288206910267
425,Bahrain,BHR,2012,202274,69554,12165,68683,150402,0.7435557708850371
426,Bahrain,BHR,2019,222168,75728,13548,77432,166708,0.7503690900579741
427,Bahrain,BHR,2014,211519,72494,12790,72088,157372,0.7440088124471088
428,Bahrain,BHR,2015,214651,73471,13009,73417,159897,0.7449161662419462
429,Bahrain,BHR,2016,216348,73783,13161,74356,161300,0.7455580823488084
430,Bahrain,BHR,2017,217966,74073,13297,75265,162635,0.7461484818733197
431,Bahrain,BHR,2018,219985,74777,13425,76342,164544,0.7479782712457668
432,Bahrain,BHR,2006,145777,50382,8398,49770,108550,0.7446304972663726
433,Bahrain,BHR,2013,207143,71102,12492,70446,154040,0.7436408664545748
434,Bahrain,BHR,2005,135893,47000,7763,46482,101245,0.7450346964155622
435,Bahrain,BHR,1997,88871,30408,4824,30026,65258,0.7343002779309336
436,Bahrain,BHR,2003,115033,39681,6440,39443,85564,0.7438213382246833
437,Bahrain,BHR,1990,73419,25013,3970,24238,53221,0.7248941009820347
438,Bahrain,BHR,1991,76114,25912,4112,25240,55264,0.7260687915495179
439,Bahrain,BHR,1992,78418,26711,4224,26033,56968,0.7264658624295443
440,Bahrain,BHR,1993,80521,27452,4324,26758,58534,0.7269407980526819
441,Bahrain,BHR,1994,82531,28164,4428,27470,60062,0.7277507845536828
442,Bahrain,BHR,1995,84525,28865,4546,28244,61655,0.7294291629695356
443,Bahrain,BHR,2004,125462,43378,7101,42965,93444,0.74479922207521
444,Bahrain,BHR,1998,91303,31290,4969,30955,67214,0.7361642005191505
445,Bahrain,BHR,1999,93963,32229,5125,31967,69321,0.7377478369145302
446,Bahrain,BHR,2000,96956,33258,5305,33122,71685,0.7393559965345105
447,Bahrain,BHR,2001,100650,34519,5535,34513,74567,0.7408544461003478
448,Bahrain,BHR,2002,106484,36615,5901,36542,79058,0.7424401788062056
449,Bahrain,BHR,1996,86585,29589,4684,29113,63386,0.7320667552116418
450,Bangladesh,BGD,2009,16048780,4200874,511891,5672905,10385670,0.6471314330435086
451,Bangladesh,BGD,2007,15855464,4165977,490066,5424720,10080763,0.6357911064602083
452,Bangladesh,BGD,2008,15939418,4178217,500915,5543314,10222446,0.6413311954050016
453,Bangladesh,BGD,2010,16208404,4259624,523025,5811082,10593731,0.6535949498790874
454,Bangladesh,BGD,2011,16411820,4348757,534328,5958619,10841704,0.660603394382829
455,Bangladesh,BGD,2012,16631664,4443311,545851,6114550,11103712,0.6676248389818361
456,Bangladesh,BGD,2013,16855498,4540295,557489,6268385,11366169,0.6743300613247974
457,Bangladesh,BGD,2016,17564361,4818964,592463,6749196,12160623,0.6923464508614916
458,Bangladesh,BGD,2015,17325560,4729810,580808,6588316,11898934,0.686784958177398
459,Bangladesh,BGD,2006,15756237,4139751,479347,5307719,9926817,0.6300246054943195
460,Bangladesh,BGD,2017,17803180,4908122,604061,6902281,12414464,0.6973172208560493
461,Bangladesh,BGD,2018,18050433,5004992,615558,7061528,12682078,0.7025913450386481
462,Bangladesh,BGD,2019,18308625,5110452,626935,7219998,12957385,0.7077202684527101
463,Bangladesh,BGD,2014,17093108,4636539,569129,6429017,11634685,0.6806652716404764
464,Bangladesh,BGD,2005,15620107,4076261,468745,5193671,9738677,0.6234705690556409
465,Bangladesh,BGD,2004,15406416,3945444,458252,5078855,9482551,0.6154936358981868
466,Bangladesh,BGD,2003,15148075,3760972,447927,4965155,9174054,0.6056250711724097
467,Bangladesh,BGD,1990,12615900,2696862,327921,3784590,6809373,0.5397453213801632
468,Bangladesh,BGD,1991,12818132,2734247,336565,3869099,6939911,0.5414136006712991
469,Bangladesh,BGD,1992,13005472,2772657,345234,3954148,7072039,0.5437741129272355
470,Bangladesh,BGD,1993,13196311,2816243,354138,4039905,7210286,0.5463864863445549
471,Bangladesh,BGD,1994,13379112,2866446,363068,4127826,7357340,0.54991243066057
472,Bangladesh,BGD,1996,13747150,2993097,380952,4303294,7677343,0.5584679733617514
473,Bangladesh,BGD,1995,13564325,2926535,371982,4216509,7515026,0.5540287482053107
474,Bangladesh,BGD,1998,14090405,3129843,399211,4475551,8004605,0.5680890648636431
475,Bangladesh,BGD,1999,14255648,3200812,408556,4562522,8171890,0.5732387612264276
476,Bangladesh,BGD,2000,14422641,3274406,418063,4654141,8346610,0.5787157844392022
477,Bangladesh,BGD,2001,14625424,3389370,427781,4752312,8569463,0.5859292010952981
478,Bangladesh,BGD,2002,14875324,3563135,437761,4856405,8857301,0.595435837229495
479,Bangladesh,BGD,1997,13920438,3060753,390019,4389569,7840341,0.5632251657598705
480,Barbados,BRB,2012,40562,13351,2930,10205,26486,0.6529756915339481
481,Barbados,BRB,2007,38360,12473,2772,9509,24754,0.6453076120959332
482,Barbados,BRB,2008,38781,12651,2805,9621,25077,0.6466310822309894
483,Barbados,BRB,2010,39654,13003,2870,9874,25747,0.6492913703535583
484,Barbados,BRB,2011,40102,13174,2901,10031,26106,0.6509899755623161
485,Barbados,BRB,2013,41004,13525,2958,10388,26871,0.6553263096283289
486,Barbados,BRB,2009,39221,12830,2838,9742,25410,0.647867213992504
487,Barbados,BRB,2015,41781,13832,3009,10709,27550,0.6593906321055025
488,Barbados,BRB,2016,42081,13953,3033,10834,27820,0.6611059623107816
489,Barbados,BRB,2017,42332,14058,3055,10943,28056,0.6627610318435226
490,Barbados,BRB,2018,42636,14150,3074,11135,28359,0.6651421334083872
491,Barbados,BRB,2019,42977,14229,3091,11420,28740,0.6687297856993275
492,Barbados,BRB,2006,37930,12303,2738,9391,24432,0.6441339309253888
493,Barbados,BRB,2014,41412,13688,2984,10557,27229,0.657514730029943
494,Barbados,BRB,2005,37523,12146,2705,9267,24118,0.6427524451669643
495,Barbados,BRB,1993,35170,11194,2481,8205,21880,0.6221211259596247
496,Barbados,BRB,2003,36756,11875,2644,8995,23514,0.6397322886059419
497,Barbados,BRB,2004,37131,12004,2673,9131,23808,0.6411893027389513
498,Barbados,BRB,1991,35280,11166,2464,8244,21874,0.6200113378684807
499,Barbados,BRB,1992,35210,11179,2473,8219,21871,0.6211587617154217
500,Barbados,BRB,1994,35149,11213,2489,8210,21912,0.6234032262653276
501,Barbados,BRB,1995,35165,11241,2498,8236,21975,0.624911133229063
502,Barbados,BRB,1996,35213,11277,2507,8291,22075,0.6268991565614972
503,Barbados,BRB,1990,35349,11153,2454,8277,21884,0.6190839910605674
504,Barbados,BRB,1998,35428,11383,2533,8437,22353,0.6309416280907757
505,Barbados,BRB,1999,35597,11456,2549,8529,22534,0.6330308733882068
506,Barbados,BRB,2000,35811,11543,2569,8621,22733,0.6348049482002737
507,Barbados,BRB,2001,36088,11644,2591,8730,22965,0.6363611172688982
508,Barbados,BRB,2002,36408,11755,2616,8859,23230,0.6380465831685344
509,Barbados,BRB,1997,35309,11324,2519,8357,22200,0.6287348834574754
510,Belarus,BLR,2007,1307149,383132,59605,486022,928759,0.7105226718606678
511,Belarus,BLR,2008,1292750,380890,59461,481195,921546,0.7128570876039451
512,Belarus,BLR,2009,1279520,378678,59278,476776,914732,0.7149024634237839
513,Belarus,BLR,2010,1268478,376529,59040,473805,909374,0.7169016727132832
514,Belarus,BLR,2011,1258736,374260,58743,471715,904718,0.7187511916716453
515,Belarus,BLR,2012,1250161,372186,58429,470176,900791,0.720539994448715
516,Belarus,BLR,2015,1232803,367168,57564,466805,891537,0.7231788047238691
517,Belarus,BLR,2014,1237451,368691,57860,467704,894255,0.7226589174035982
518,Belarus,BLR,2016,1229402,365481,57270,466629,889380,0.7234248846187008
519,Belarus,BLR,2017,1226154,363922,56945,465936,886803,0.7232394952020709
520,Belarus,BLR,2018,1220689,362816,56633,462493,881942,0.7224952465369967
521,Belarus,BLR,2006,1320844,385400,59738,490063,935201,0.7080328941192147
522,Belarus,BLR,2013,1243009,370386,58147,468876,897409,0.7219650058849132
523,Belarus,BLR,2005,1333028,387756,59860,492573,940189,0.7053032644475585
524,Belarus,BLR,2019,1213285,361850,56320,456449,874619,0.720868551082392
525,Belarus,BLR,2003,1352838,391988,59978,492959,944925,0.6984760924811396
526,Belarus,BLR,2004,1343422,389917,59942,493201,943060,0.7019834422839585
527,Belarus,BLR,1990,1315857,387871,58573,455867,902311,0.6857211687896178
528,Belarus,BLR,1991,1325777,389863,58775,459580,908218,0.6850458259571557
529,Belarus,BLR,1992,1335079,391734,58984,463534,914252,0.6847924355038166
530,Belarus,BLR,1994,1350135,394640,59270,470489,924399,0.6846715328467153
531,Belarus,BLR,1995,1355870,395639,59401,473465,928505,0.6848038528767507
532,Belarus,BLR,1993,1343369,393353,59140,467245,919738,0.6846503082920627
533,Belarus,BLR,1997,1367127,397052,59651,481205,937908,0.686043066957203
534,Belarus,BLR,1998,1371587,397321,59766,485176,942263,0.6869874094753012
535,Belarus,BLR,1999,1373505,397121,59861,488464,945446,0.6883455102092821
536,Belarus,BLR,2000,1372597,396574,59944,490679,947197,0.6900765483240893
537,Belarus,BLR,2001,1368545,395562,60001,491865,947428,0.6922885254047182
538,Belarus,BLR,2002,1361845,393982,60005,492844,946831,0.6952560680547346
539,Belarus,BLR,1996,1361368,396409,59518,476819,932746,0.6851534632810526
540,Belgium,BEL,2011,1567435,574452,111026,460773,1146251,0.7312909307244001
541,Belgium,BEL,2007,1499977,547368,108058,427561,1082987,0.7220024040368619
542,Belgium,BEL,2008,1521685,555300,108814,440554,1104668,0.7259505088109562
543,Belgium,BEL,2009,1541741,562940,109553,451773,1124266,0.7292184614666147
544,Belgium,BEL,2010,1556502,569090,110277,458400,1137767,0.7309768956287881
545,Belgium,BEL,2012,1576718,579964,111752,461686,1153402,0.7315207919234765
546,Belgium,BEL,2019,1623114,599644,115466,469480,1184590,0.7298255082514229
547,Belgium,BEL,2014,1592534,589865,112993,461599,1164457,0.7311975756875521
548,Belgium,BEL,2015,1599908,593877,113539,462161,1169577,0.7310276590903977
549,Belgium,BEL,2006,1479894,540388,107307,415509,1063204,0.7184325363843627
550,Belgium,BEL,2016,1606964,596818,114085,463482,1174385,0.7308097754523437
551,Belgium,BEL,2017,1613522,598963,114597,464838,1178398,0.7303265775118034
552,Belgium,BEL,2018,1619003,599994,115051,466910,1181955,0.7300511487625408
553,Belgium,BEL,2013,1584882,585151,112409,461668,1159228,0.7314285858505555
554,Belgium,BEL,2005,1464948,535634,106614,407050,1049298,0.7162697925114065
555,Belgium,BEL,1993,1408468,525108,101434,377942,1004484,0.7131748822124464
556,Belgium,BEL,2003,1444894,529447,105245,397151,1031843,0.7141305867420032
557,Belgium,BEL,1990,1403752,522852,100659,377671,1001182,0.7132185742210875
558,Belgium,BEL,1991,1405293,523794,100919,377497,1002210,0.7131680012637934
559,Belgium,BEL,1992,1406858,524535,101180,377588,1003303,0.7131515760652462
560,Belgium,BEL,1994,1410053,525620,101672,378658,1005950,0.7134129000824792
561,Belgium,BEL,1995,1412198,526231,101904,379492,1007627,0.7135168014683494
562,Belgium,BEL,1996,1413846,526012,102175,380246,1008433,0.7132551918667238
563,Belgium,BEL,2004,1454539,532491,105942,401783,1040216,0.7151516734855511
564,Belgium,BEL,1998,1414102,522474,102805,381215,1006494,0.7117548804824546
565,Belgium,BEL,1999,1415503,521107,103145,382610,1006862,0.7113103963749988
566,Belgium,BEL,2000,1420189,521602,103503,385299,1010404,0.7114574186956807
567,Belgium,BEL,2001,1427504,523832,103975,389099,1016906,0.7123664802340308
568,Belgium,BEL,2002,1436221,526545,104580,393004,1024129,0.7130720132904337
569,Belgium,BEL,1997,1414104,524466,102478,380615,1007559,0.7125070008995095
570,Belize,BLZ,2007,40107,11490,2530,8558,22578,0.5629441244670507
571,Belize,BLZ,2008,41487,11958,2626,8833,23417,0.5644418733579194
572,Belize,BLZ,2009,42920,12439,2725,9120,24284,0.5657968313140727
573,Belize,BLZ,2010,44379,12916,2825,9439,25180,0.5673854751121026
574,Belize,BLZ,2011,45856,13394,2926,9795,26115,0.5695001744591766
575,Belize,BLZ,2012,47354,13886,3029,10163,27078,0.571820754318537
576,Belize,BLZ,2015,51809,15364,3346,11334,30044,0.5798992453048698
577,Belize,BLZ,2014,50351,14880,3239,10945,29064,0.5772278604198526
578,Belize,BLZ,2016,53252,15838,3454,11746,31038,0.5828513483061669
579,Belize,BLZ,2017,54667,16307,3561,12159,32027,0.5858561838037573
580,Belize,BLZ,2018,56051,16780,3669,12573,33022,0.5891420313642932
581,Belize,BLZ,2006,38741,11047,2437,8285,21769,0.5619111535582458
582,Belize,BLZ,2013,48861,14384,3134,10554,28072,0.5745277419618919
583,Belize,BLZ,2005,37422,10637,2348,7988,20973,0.5604457271123938
584,Belize,BLZ,2019,57428,17263,3776,12983,34022,0.5924287803858744
585,Belize,BLZ,2003,34955,9901,2178,7376,19455,0.5565727363753398
586,Belize,BLZ,1990,23800,6546,1395,4562,12503,0.5253361344537815
587,Belize,BLZ,1991,24409,6733,1439,4691,12863,0.5269777541070917
588,Belize,BLZ,1992,25043,6932,1485,4832,13249,0.5290500339416204
589,Belize,BLZ,1993,25723,7141,1534,4993,13668,0.5313532636162189
590,Belize,BLZ,1994,26444,7362,1585,5164,14111,0.5336182120707911
591,Belize,BLZ,1995,27200,7594,1639,5348,14581,0.5360661764705882
592,Belize,BLZ,2004,36158,10259,2261,7680,20200,0.5586592178770949
593,Belize,BLZ,1997,28862,8093,1755,5773,15621,0.5412306839442866
594,Belize,BLZ,1998,29768,8359,1817,6017,16193,0.5439733942488578
595,Belize,BLZ,1999,30702,8638,1882,6266,16786,0.5467396260829913
596,Belize,BLZ,2000,31682,8931,1950,6520,17401,0.5492393156997665
597,Belize,BLZ,2001,32716,9238,2022,6787,18047,0.5516261156620613
598,Belize,BLZ,2002,33803,9561,2098,7074,18733,0.5541815815164335
599,Belize,BLZ,1996,28010,7838,1696,5550,15084,0.5385219564441271
600,Benin,BEN,2006,794210,225297,33565,241356,500218,0.6298309011470518
601,Benin,BEN,2007,821808,233235,34793,249879,517907,0.6302043786383195
602,Benin,BEN,2008,850877,241507,36070,258583,536160,0.63012632848226
603,Benin,BEN,2009,880964,250207,37412,267787,555406,0.630452549706912
604,Benin,BEN,2010,912801,259417,38822,277513,575752,0.6307530337937842
605,Benin,BEN,2011,945354,269316,40284,287916,597516,0.6320552935725665
606,Benin,BEN,2015,1087582,314695,46700,333739,695134,0.6391554843680752
607,Benin,BEN,2013,1014459,291222,43377,310160,644759,0.6355693034415388
608,Benin,BEN,2014,1050795,302863,45005,321826,669694,0.6373212662793408
609,Benin,BEN,2016,1125579,327160,48447,346463,722070,0.6415098362709326
610,Benin,BEN,2017,1164606,339825,50259,359569,749653,0.643696666512108
611,Benin,BEN,2018,1205401,352177,52128,373357,777662,0.6451479632089239
612,Benin,BEN,2005,767522,217610,32388,233136,483134,0.6294725102342343
613,Benin,BEN,2012,979268,279976,41806,298652,620434,0.633569155736734
614,Benin,BEN,2019,1247943,364608,54064,387939,806611,0.6463524375712673
615,Benin,BEN,2004,741849,210049,31254,225094,466397,0.6286953274857822
616,Benin,BEN,2002,693670,195511,29128,209693,434332,0.6261363472544582
617,Benin,BEN,2003,717223,202653,30170,217302,450125,0.627594207101557
618,Benin,BEN,1990,460724,128557,19025,137220,284802,0.6181618496106128
619,Benin,BEN,1991,477535,133349,19724,142014,295087,0.6179379521919859
620,Benin,BEN,1992,494861,138286,20448,147036,305770,0.6178906804132878
621,Benin,BEN,1994,530467,148545,21975,157602,328122,0.6185530862428765
622,Benin,BEN,1995,548997,153876,22768,163137,339781,0.6189123073532278
623,Benin,BEN,1993,512518,143349,21200,152215,316764,0.618054390284829
624,Benin,BEN,1997,587523,164771,24435,175157,364363,0.6201680615056773
625,Benin,BEN,1998,607486,170377,25311,181725,377413,0.6212702844180771
626,Benin,BEN,1999,628054,176180,26217,188427,390824,0.622277702235795
627,Benin,BEN,2000,649300,182257,27153,195231,404641,0.6231957492684429
628,Benin,BEN,2001,671304,188686,28123,202315,419124,0.624343069607808
629,Benin,BEN,1996,567933,159282,23589,168975,351846,0.619520260312396
630,Bermuda,BMU,2011,9405,3114,721,2523,6358,0.6760233918128655
631,Bermuda,BMU,2007,9382,3056,718,2524,6298,0.6712854402046472
632,Bermuda,BMU,2008,9388,3076,720,2514,6310,0.6721346399659139
633,Bermuda,BMU,2009,9393,3093,721,2508,6322,0.673054402214415
634,Bermuda,BMU,2010,9399,3105,721,2512,6338,0.6743270560697947
635,Bermuda,BMU,2012,9409,3124,720,2535,6379,0.6779679030715272
636,Bermuda,BMU,2006,9370,3037,716,2531,6284,0.6706510138740661
637,Bermuda,BMU,2014,9400,3136,715,2557,6408,0.6817021276595745
638,Bermuda,BMU,2015,9383,3135,713,2564,6412,0.6833635297879143
639,Bermuda,BMU,2016,9356,3128,709,2569,6406,0.6846943138093202
640,Bermuda,BMU,2017,9326,3119,706,2573,6398,0.6860390306669526
641,Bermuda,BMU,2018,9301,3111,702,2583,6396,0.6876679926889582
642,Bermuda,BMU,2013,9407,3131,718,2547,6396,0.6799192090996067
643,Bermuda,BMU,2019,9277,3103,698,2598,6399,0.6897703999137652
644,Bermuda,BMU,2005,9352,3019,713,2529,6261,0.6694824636441403
645,Bermuda,BMU,2003,9299,2989,707,2513,6209,0.6677062049682762
646,Bermuda,BMU,1990,8712,2728,652,2364,5744,0.6593204775022957
647,Bermuda,BMU,1991,8758,2747,658,2373,5778,0.6597396665905458
648,Bermuda,BMU,1992,8806,2767,663,2383,5813,0.6601181012945719
649,Bermuda,BMU,1993,8854,2787,668,2393,5848,0.660492432798735
650,Bermuda,BMU,1994,8900,2807,672,2403,5882,0.6608988764044944
651,Bermuda,BMU,1995,8951,2828,677,2414,5919,0.661266897553346
652,Bermuda,BMU,2004,9327,3004,710,2522,6236,0.6685965476573389
653,Bermuda,BMU,1997,9049,2872,685,2439,5996,0.6626146535528787
654,Bermuda,BMU,1998,9095,2895,688,2451,6034,0.6634414513468939
655,Bermuda,BMU,1999,9143,2917,692,2465,6074,0.664333369791097
656,Bermuda,BMU,2000,9188,2938,696,2479,6113,0.6653243360905529
657,Bermuda,BMU,2001,9229,2956,700,2493,6149,0.66626936829559
658,Bermuda,BMU,2002,9267,2973,703,2505,6181,0.6669903960289199
659,Bermuda,BMU,1996,8999,2850,681,2427,5958,0.6620735637293033
660,Bhutan,BTN,2007,77574,20534,2510,23200,46244,0.5961275685152242
661,Bhutan,BTN,2008,79088,21088,2585,23723,47396,0.5992818126643739
662,Bhutan,BTN,2009,80779,21691,2665,24338,48694,0.6028051845157776
663,Bhutan,BTN,2010,82555,22316,2748,25032,50096,0.6068196959602689
664,Bhutan,BTN,2011,84269,22926,2825,25760,51511,0.6112686753135791
665,Bhutan,BTN,2012,85566,23441,2884,26420,52745,0.6164247481476287
666,Bhutan,BTN,2015,87845,24521,2996,27978,55495,0.6317377198474586
667,Bhutan,BTN,2014,87259,24226,2964,27520,54710,0.6269840360306673
668,Bhutan,BTN,2016,88132,24709,3019,28314,56042,0.6358870784731993
669,Bhutan,BTN,2017,88195,24825,3034,28587,56446,0.6400136062135041
670,Bhutan,BTN,2018,88412,24983,3045,29038,57066,0.645455368049586
671,Bhutan,BTN,2006,76410,20077,2450,22754,45281,0.5926056798848318
672,Bhutan,BTN,2013,86511,23864,2928,27002,53794,0.6218168787784213
673,Bhutan,BTN,2005,75581,19712,2402,22389,44503,0.5888120030166312
674,Bhutan,BTN,2019,88835,25213,3055,29646,57914,0.6519277311870322
675,Bhutan,BTN,2003,74644,19164,2333,21814,43311,0.5802341782326778
676,Bhutan,BTN,1990,69154,16096,1946,18467,36509,0.5279376464123551
677,Bhutan,BTN,1991,66679,15655,1882,17974,35511,0.5325664752020877
678,Bhutan,BTN,1992,65271,15455,1852,17743,35050,0.5369919259701859
679,Bhutan,BTN,1993,65399,15609,1870,17884,35363,0.5407269224300065
680,Bhutan,BTN,1994,66154,15908,1908,18185,36001,0.5441998972095414
681,Bhutan,BTN,1995,67273,16295,1959,18590,36844,0.5476788607613753
682,Bhutan,BTN,2004,75050,19426,2366,22076,43868,0.5845169886742172
683,Bhutan,BTN,1997,69829,17138,2071,19541,38750,0.5549270360451961
684,Bhutan,BTN,1998,70967,17539,2124,20006,39669,0.5589781165894007
685,Bhutan,BTN,1999,71912,17900,2171,20424,40495,0.5631188118811881
686,Bhutan,BTN,2000,72764,18237,2216,20827,41280,0.567313506679127
687,Bhutan,BTN,2001,73483,18556,2257,21184,41997,0.5715199433882667
688,Bhutan,BTN,2002,74122,18869,2297,21509,42675,0.5757399962224441
689,Bhutan,BTN,1996,68486,16702,2013,19049,37764,0.5514119674093976
690,Bolivia,BOL,2006,1317868,494639,77834,281386,853859,0.647909350557112
691,Bolivia,BOL,2007,1345530,507442,79878,287740,875060,0.6503459603279005
692,Bolivia,BOL,2008,1372170,520418,81906,293862,896186,0.6531158675674297
693,Bolivia,BOL,2009,1398950,533383,83923,300311,917617,0.655932663783552
694,Bolivia,BOL,2010,1425715,546111,85926,307149,939186,0.6587473653570314
695,Bolivia,BOL,2011,1452771,559096,87895,314721,961712,0.661984579813336
696,Bolivia,BOL,2015,1563661,612787,95501,344444,1052732,0.6732482296354517
697,Bolivia,BOL,2013,1508217,586587,91744,329442,1007773,0.6681883309895061
698,Bolivia,BOL,2014,1536014,600115,93632,336895,1030642,0.6709847696700681
699,Bolivia,BOL,2016,1590534,624004,97338,351996,1073338,0.6748287053278962
700,Bolivia,BOL,2017,1617985,635190,99155,359672,1094017,0.6761601621770288
701,Bolivia,BOL,2018,1646176,647638,100946,366451,1115035,0.6773485945609704
702,Bolivia,BOL,2005,1289648,482246,75788,274804,832838,0.6457870674788779
703,Bolivia,BOL,2012,1480285,572751,89835,321971,984557,0.6651131369972674
704,Bolivia,BOL,2019,1675307,661031,102733,372371,1136135,0.678165255681496
705,Bolivia,BOL,2004,1260922,470294,73736,267994,812024,0.6439922532876736
706,Bolivia,BOL,2002,1202069,446816,69654,254231,770701,0.6411453918202699
707,Bolivia,BOL,2003,1231794,458562,71692,261077,791331,0.6424215412642049
708,Bolivia,BOL,1990,859739,313035,48118,180084,541237,0.6295364058161838
709,Bolivia,BOL,1991,882158,320997,49459,185031,555487,0.6296910530766597
710,Bolivia,BOL,1992,905897,329639,50904,190275,570818,0.6301135780337058
711,Bolivia,BOL,1994,958609,349139,54109,201777,605025,0.631148883434226
712,Bolivia,BOL,1995,987016,359970,55855,208030,623855,0.632061688969581
713,Bolivia,BOL,1993,931335,339022,52456,195884,587362,0.6306667310903166
714,Bolivia,BOL,1997,1046803,383829,59584,220725,664138,0.6344441122159565
715,Bolivia,BOL,1998,1077471,396549,61532,227073,685154,0.6358908963675124
716,Bolivia,BOL,1999,1108442,409483,63527,233606,706616,0.6374857683126406
717,Bolivia,BOL,2000,1140101,422334,65559,240404,728297,0.6388004220678695
718,Bolivia,BOL,2001,1171319,434797,67607,247344,749748,0.6400886521946626
719,Bolivia,BOL,1996,1016516,371554,57684,214426,643664,0.6332059701962389
720,Bosnia and Herzegovina,BIH,2011,442335,148432,23625,125157,297214,0.6719206031627613
721,Bosnia and Herzegovina,BIH,2007,478029,157208,25135,136289,318632,0.6665537028088254
722,Bosnia and Herzegovina,BIH,2008,468334,155038,24747,132799,312584,0.6674381958175148
723,Bosnia and Herzegovina,BIH,2009,458651,152739,24343,129611,306693,0.6686849042082106
724,Bosnia and Herzegovina,BIH,2010,449842,150492,23957,127045,301494,0.6702219890539345
725,Bosnia and Herzegovina,BIH,2012,435671,146516,23330,123467,293313,0.6732442600035348
726,Bosnia and Herzegovina,BIH,2006,484213,158175,25302,138958,322435,0.6658949677104911
727,Bosnia and Herzegovina,BIH,2014,422059,142362,22661,120277,285300,0.6759718427992295
728,Bosnia and Herzegovina,BIH,2015,415557,140343,22324,118977,281644,0.6777505853589278
729,Bosnia and Herzegovina,BIH,2016,409267,138372,22005,117897,278274,0.6799326600971982
730,Bosnia and Herzegovina,BIH,2017,403417,136512,21692,116949,275153,0.6820560363098234
731,Bosnia and Herzegovina,BIH,2018,398335,134876,21380,116437,272693,0.6845820728783562
732,Bosnia and Herzegovina,BIH,2013,428955,144478,23005,121832,289315,0.6744646874380763
733,Bosnia and Herzegovina,BIH,2005,489942,159035,25435,141178,325648,0.6646664299039479
734,Bosnia and Herzegovina,BIH,2019,393992,133390,21072,116461,270923,0.6876357895591788
735,Bosnia and Herzegovina,BIH,2003,503726,161371,25782,145919,333072,0.6612166137940071
736,Bosnia and Herzegovina,BIH,1990,555059,166659,26753,155261,348673,0.6281728609030751
737,Bosnia and Herzegovina,BIH,1991,555584,166059,26622,154662,347343,0.625185390508006
738,Bosnia and Herzegovina,BIH,1992,541682,161875,25866,150704,338445,0.6248038517063517
739,Bosnia and Herzegovina,BIH,1993,526160,157509,25075,146613,329197,0.6256594952105823
740,Bosnia and Herzegovina,BIH,1994,508942,152866,24237,142337,319440,0.6276550176640954
741,Bosnia and Herzegovina,BIH,1995,489093,147507,23279,137601,308387,0.6305283453249177
742,Bosnia and Herzegovina,BIH,2004,499124,160941,25746,144112,330799,0.6627591540378743
743,Bosnia and Herzegovina,BIH,1997,500930,152993,24192,142169,319354,0.6375222086918332
744,Bosnia and Herzegovina,BIH,1998,510885,157508,24979,146025,328512,0.6430253383833935
745,Bosnia and Herzegovina,BIH,1999,510457,159105,25268,147228,331601,0.6496159323899956
746,Bosnia and Herzegovina,BIH,2000,505244,158835,25234,146774,330843,0.6548182660259202
747,Bosnia and Herzegovina,BIH,2001,501935,158831,25257,146155,330243,0.6579397730781874
748,Bosnia and Herzegovina,BIH,2002,502330,159984,25492,146066,331542,0.660008361037565
749,Bosnia and Herzegovina,BIH,1996,487288,147717,23292,137640,308649,0.6334016023378372
750,Botswana,BWA,2007,200938,64142,9602,68447,142191,0.7076361862863172
751,Botswana,BWA,2009,209563,67077,10114,71658,148849,0.7102828266440163
752,Botswana,BWA,2010,214206,68616,10376,73495,152487,0.711870815943531
753,Botswana,BWA,2011,219074,70256,10636,75446,156338,0.7136310105261235
754,Botswana,BWA,2012,224146,72028,10894,77404,160326,0.7152748654894577
755,Botswana,BWA,2015,239836,77462,11664,83562,172688,0.7200253506562818
756,Botswana,BWA,2014,234627,75705,11407,81495,168607,0.7186172094430735
757,Botswana,BWA,2006,196787,62738,9354,66861,138953,0.7061086352248879
758,Botswana,BWA,2016,245258,79160,11919,85773,176852,0.7210855507261741
759,Botswana,BWA,2017,250640,80791,12175,88013,180979,0.722067507181615
760,Botswana,BWA,2018,255743,82165,12430,90331,184926,0.7230931051876298
761,Botswana,BWA,2019,260564,83260,12684,92664,188608,0.7238451973411523
762,Botswana,BWA,2013,229393,73870,11151,79439,164460,0.7169355647295254
763,Botswana,BWA,2005,192663,61391,9116,65220,135727,0.704478804959956
764,Botswana,BWA,2008,205151,65587,9856,69995,145438,0.7089314699903974
765,Botswana,BWA,2003,185173,58924,8689,62103,129716,0.7005124937220869
766,Botswana,BWA,1990,126954,40438,5740,39283,85461,0.6731650834160404
767,Botswana,BWA,1991,132084,42076,5989,41141,89206,0.6753732473274583
768,Botswana,BWA,1992,137215,43724,6243,43029,92996,0.6777393142149182
769,Botswana,BWA,1993,142348,45362,6496,44965,96823,0.6801851799814539
770,Botswana,BWA,1994,147430,46972,6746,46917,100635,0.6825951298921522
771,Botswana,BWA,1995,152359,48540,6991,48800,104331,0.6847708372987483
772,Botswana,BWA,2004,188779,60116,8893,63603,132612,0.7024722029463023
773,Botswana,BWA,1997,161936,51506,7462,52662,111630,0.6893464084576623
774,Botswana,BWA,1998,166487,52891,7686,54541,115118,0.6914533867509175
775,Botswana,BWA,1999,170702,54205,7900,56306,118411,0.6936708415835784
776,Botswana,BWA,2000,174612,55449,8106,57888,121443,0.695502027352072
777,Botswana,BWA,2001,178252,56632,8303,59331,124266,0.6971366380180868
778,Botswana,BWA,2002,181742,57779,8495,60691,126965,0.6986002134894521
779,Botswana,BWA,1996,157236,50053,7230,50727,108010,0.6869292019639268
780,Brazil,BRA,2006,33728276,16706915,2210015,8584356,27501286,0.8153777560406585
781,Brazil,BRA,2007,33991971,16955997,2246299,8485854,27688150,0.8145497064586222
782,Brazil,BRA,2008,34170600,17177754,2281920,8315631,27775305,0.8128421801197521
783,Brazil,BRA,2009,34360037,17396789,2316776,8166023,27879588,0.8113957502432259
784,Brazil,BRA,2010,34668140,17638112,2350902,8135488,28124502,0.81124923344604
785,Brazil,BRA,2011,34887473,17651759,2384019,8200624,28236402,0.8093564701576408
786,Brazil,BRA,2015,34785927,16378743,2505754,8522725,27407222,0.7878824675277448
787,Brazil,BRA,2013,34685370,16823275,2447072,8349571,27619918,0.7962987853380258
788,Brazil,BRA,2014,34602476,16429350,2476872,8432880,27339102,0.7900909171933246
789,Brazil,BRA,2016,35205664,16622492,2533286,8603382,27759160,0.7884856254948067
790,Brazil,BRA,2017,35626365,16872513,2559294,8698146,28129953,0.7895824623140756
791,Brazil,BRA,2018,36024147,17097288,2583907,8814509,28495704,0.7910167588423398
792,Brazil,BRA,2005,33285033,16404896,2173125,8529118,27107139,0.814394235391024
793,Brazil,BRA,2012,34839296,17308428,2416092,8271537,27996057,0.8035770010966926
794,Brazil,BRA,2019,36413436,17319782,2607421,8931545,28858748,0.7925302078057122
795,Brazil,BRA,2004,32604674,15930192,2135824,8357601,26423617,0.8104242048241305
796,Brazil,BRA,2002,30777807,14466223,2060392,7959310,24485925,0.7955708150356522
797,Brazil,BRA,1990,21389914,8178793,1588903,5295385,15063081,0.7042141917915145
798,Brazil,BRA,1991,21851245,8466733,1625355,5403798,15495886,0.7091534601346514
799,Brazil,BRA,1992,22342363,8764723,1663164,5527598,15955485,0.7141359667283178
800,Brazil,BRA,1993,22848975,9059309,1701936,5662650,16423895,0.7188022657471506
801,Brazil,BRA,1994,23359280,9337540,1741418,5809030,16887988,0.7229669750095037
802,Brazil,BRA,1995,23869871,9586883,1781493,5963045,17331421,0.72607937428736
803,Brazil,BRA,2003,31740390,15251169,2098307,8164877,25514353,0.8038449748096983
804,Brazil,BRA,1997,25554510,10597719,1862630,6523280,18983629,0.7428680495145475
805,Brazil,BRA,1998,26701334,11376771,1903213,6903164,20183148,0.7558853801087242
806,Brazil,BRA,1999,27857996,12198356,1943379,7264797,21406532,0.7684160770214771
807,Brazil,BRA,2000,28864563,12942716,1983039,7538544,22464299,0.7782656886231051
808,Brazil,BRA,2001,29793787,13668140,2022009,7748347,23438496,0.7866907285065843
809,Brazil,BRA,1996,24565833,9969258,1821953,6191532,17982743,0.7320225208727911
810,Brunei,BRN,2007,37312,11286,2377,5760,19423,0.5205563893653516
811,Brunei,BRN,2008,37908,11473,2430,5846,19749,0.520971826527382
812,Brunei,BRN,2009,38511,11657,2482,5938,20077,0.5213315676040612
813,Brunei,BRN,2010,39132,11846,2535,6051,20432,0.522130225902075
814,Brunei,BRN,2011,39766,12035,2586,6189,20810,0.523311371523412
815,Brunei,BRN,2012,40400,12218,2636,6347,21201,0.5247772277227722
816,Brunei,BRN,2015,42133,12729,2781,6805,22315,0.5296323546863504
817,Brunei,BRN,2014,41599,12566,2733,6671,21970,0.5281376956176831
818,Brunei,BRN,2016,42616,12866,2827,6913,22606,0.5304580439271636
819,Brunei,BRN,2017,43054,12995,2870,7018,22883,0.5314953314442328
820,Brunei,BRN,2018,43552,13131,2911,7200,23242,0.5336609110947832
821,Brunei,BRN,2006,36688,11090,2324,5664,19078,0.5200065416484955
822,Brunei,BRN,2013,41013,12395,2685,6512,21592,0.5264672177114573
823,Brunei,BRN,2019,44105,13269,2951,7480,23700,0.5373540414918944
824,Brunei,BRN,2005,36011,10879,2271,5554,18704,0.519396850962206
825,Brunei,BRN,2003,34560,10432,2142,5300,17874,0.5171875
826,Brunei,BRN,2004,35290,10658,2211,5429,18298,0.518503825446302
827,Brunei,BRN,1990,24538,7164,1426,3721,12311,0.5017116309397669
828,Brunei,BRN,1991,25260,7401,1475,3809,12685,0.5021773555027712
829,Brunei,BRN,1992,25997,7643,1524,3900,13067,0.5026349194137785
830,Brunei,BRN,1994,27514,8139,1625,4105,13869,0.5040706549393036
831,Brunei,BRN,1995,28295,8393,1677,4224,14294,0.5051775932143489
832,Brunei,BRN,1993,26752,7889,1574,3999,13462,0.5032147129186603
833,Brunei,BRN,1997,29874,8917,1782,4484,15183,0.508234585258084
834,Brunei,BRN,1998,30679,9184,1835,4622,15641,0.5098275693471104
835,Brunei,BRN,1999,31467,9450,1889,4757,16096,0.5115200050846919
836,Brunei,BRN,2000,32254,9709,1944,4893,16546,0.5129906368202394
837,Brunei,BRN,2001,33035,9958,2004,5030,16992,0.5143635538065688
838,Brunei,BRN,2002,33808,10199,2071,5165,17435,0.5157063416942735
839,Brunei,BRN,1996,29082,8652,1730,4356,14738,0.5067739495220411
840,Bulgaria,BGR,2011,861461,289383,40195,261513,591091,0.6861494600452023
841,Bulgaria,BGR,2007,901360,297271,41876,272740,611887,0.6788486287387947
842,Bulgaria,BGR,2008,892544,296811,41552,269907,608270,0.6815014161766815
843,Bulgaria,BGR,2009,882900,295602,41155,267050,603807,0.683890587835542
844,Bulgaria,BGR,2010,872482,293003,40690,264261,597954,0.6853482364106079
845,Bulgaria,BGR,2012,851552,285947,39749,258844,584540,0.6864407575814513
846,Bulgaria,BGR,2006,909597,297660,42140,275666,615466,0.6766359167851257
847,Bulgaria,BGR,2014,836411,280345,39020,254988,574353,0.686687525630342
848,Bulgaria,BGR,2015,829660,277973,38672,253327,569972,0.6869946725164525
849,Bulgaria,BGR,2016,823947,275741,38310,252632,566683,0.6877663247757441
850,Bulgaria,BGR,2017,818325,273650,37944,251977,563571,0.6886884795160847
851,Bulgaria,BGR,2018,812529,271858,37577,250512,559947,0.6891409414310136
852,Bulgaria,BGR,2019,806533,270342,37213,248876,556431,0.6899048148060898
853,Bulgaria,BGR,2013,843355,282965,39365,256695,579025,0.6865732698567033
854,Bulgaria,BGR,2005,917467,298581,42350,278117,619048,0.6747359850545033
855,Bulgaria,BGR,1996,984467,315749,43600,298823,658172,0.6685566910825858
856,Bulgaria,BGR,2003,932475,301067,42614,282834,626515,0.6718839647175527
857,Bulgaria,BGR,1990,1016126,325449,44979,303553,673981,0.6632848682151623
858,Bulgaria,BGR,1991,1011559,324115,44719,303108,671942,0.6642637750244919
859,Bulgaria,BGR,1992,1006642,322697,44462,302517,669676,0.665257360610823
860,Bulgaria,BGR,1993,1001745,321250,44232,301757,667239,0.6660766961651917
861,Bulgaria,BGR,1994,996455,319706,44021,301081,664808,0.6671731287413882
862,Bulgaria,BGR,1995,990965,318040,43810,300185,662035,0.6680710216808868
863,Bulgaria,BGR,2004,925008,299888,42501,280414,622803,0.6732947174510923
864,Bulgaria,BGR,1997,976290,312651,43399,296494,652544,0.6683915639820135
865,Bulgaria,BGR,1998,968176,309443,43220,294039,646702,0.6679591313975971
866,Bulgaria,BGR,1999,960787,306720,43075,291825,641620,0.667806704295541
867,Bulgaria,BGR,2000,954072,304860,42946,289750,637556,0.6682472601648513
868,Bulgaria,BGR,2001,947368,303550,42821,287666,634037,0.6692615752273667
869,Bulgaria,BGR,2002,939990,302269,42714,285202,630185,0.6704167065607081
870,Burkina Faso,BFA,2007,1496128,411947,62076,447275,921298,0.6157882213286564
871,Burkina Faso,BFA,2009,1604447,440876,66601,476785,984262,0.6134587181751718
872,Burkina Faso,BFA,2010,1659976,456326,68983,493282,1018591,0.6136179077287864
873,Burkina Faso,BFA,2011,1718801,472822,71469,513791,1058082,0.6155930791289975
874,Burkina Faso,BFA,2012,1782582,490450,74024,538832,1103306,0.6189370250569118
875,Burkina Faso,BFA,2013,1849230,508970,76676,567221,1152867,0.6234308333738907
876,Burkina Faso,BFA,2016,2047057,567128,85250,643412,1295790,0.6330014259495461
877,Burkina Faso,BFA,2015,1981950,547391,82280,620453,1250124,0.6307545599031257
878,Burkina Faso,BFA,2006,1444911,398351,59935,432840,891126,0.6167341794754141
879,Burkina Faso,BFA,2017,2113272,587278,88312,666043,1341633,0.6348605385392888
880,Burkina Faso,BFA,2018,2172657,607454,91486,680454,1379394,0.6348880656265578
881,Burkina Faso,BFA,2019,2221460,627700,94775,683906,1406381,0.6330885993895906
882,Burkina Faso,BFA,2014,1915700,528073,79428,595148,1202649,0.6277856658140627
883,Burkina Faso,BFA,2005,1397239,385201,57850,418671,861722,0.6167319978901248
884,Burkina Faso,BFA,2008,1549460,426101,64297,461677,952075,0.6144560040272095
885,Burkina Faso,BFA,2003,1307695,360200,53968,386525,800693,0.6122933864547926
886,Burkina Faso,BFA,2004,1351668,372485,55868,403191,831544,0.6151984067093399
887,Burkina Faso,BFA,1991,955073,256710,38160,283308,578178,0.6053757147359417
888,Burkina Faso,BFA,1992,974083,262593,39055,286052,587700,0.6033366766487045
889,Burkina Faso,BFA,1993,994180,268765,39994,289379,598138,0.601639542135227
890,Burkina Faso,BFA,1994,1016133,275330,40987,293847,610164,0.6004765124250467
891,Burkina Faso,BFA,1995,1040096,282391,42047,299764,624202,0.6001388333384611
892,Burkina Faso,BFA,1996,1065996,290033,43194,306702,639929,0.6003108829676659
893,Burkina Faso,BFA,1990,936911,250997,37295,281193,569485,0.6078325475952359
894,Burkina Faso,BFA,1998,1124050,307180,45780,323404,676364,0.6017205640318491
895,Burkina Faso,BFA,1999,1156079,316670,47230,332900,696800,0.6027269762706527
896,Burkina Faso,BFA,2000,1190503,326666,48775,343350,718791,0.6037708430806138
897,Burkina Faso,BFA,2001,1226649,337252,50430,355417,743099,0.605795953039541
898,Burkina Faso,BFA,2002,1265994,348435,52156,370225,770816,0.608862285287292
899,Burkina Faso,BFA,1997,1094007,298281,44432,314611,657324,0.6008407624448473
900,Burundi,BDI,2007,882251,238153,36364,266352,540869,0.613055695034633
901,Burundi,BDI,2008,925880,250915,38468,277746,567129,0.6125297014731931
902,Burundi,BDI,2010,982443,267709,41112,292672,601493,0.6122421351671293
903,Burundi,BDI,2011,1010888,276544,42368,300928,619840,0.613163871764231
904,Burundi,BDI,2012,1046903,288245,43969,311741,643955,0.6151047422731619
905,Burundi,BDI,2013,1077092,298758,45299,320766,664823,0.6172388245386652
906,Burundi,BDI,2016,1162250,326524,48791,347251,722566,0.6216958485695848
907,Burundi,BDI,2015,1122389,314377,47130,335029,696536,0.6205834162665529
908,Burundi,BDI,2017,1215071,342201,51034,363038,756273,0.6224105422646085
909,Burundi,BDI,2018,1267052,356869,53172,378797,788838,0.6225774474922892
910,Burundi,BDI,2019,1315903,370083,55096,393629,818808,0.6222403930988835
911,Burundi,BDI,2006,846555,227708,34646,257450,519804,0.6140227155943796
912,Burundi,BDI,2014,1098338,306477,46168,327465,680110,0.6192173993797901
913,Burundi,BDI,2005,818221,219367,33278,250380,503025,0.6147788922552709
914,Burundi,BDI,2009,959908,261026,40105,286569,587700,0.6122461735916359
915,Burundi,BDI,2003,764272,203804,30730,237231,471765,0.6172736931354282
916,Burundi,BDI,1991,606028,160805,24286,207010,392101,0.6470014586784769
917,Burundi,BDI,1992,601097,159221,23975,204868,388064,0.6455929741788763
918,Burundi,BDI,1993,626589,166006,25018,212114,403138,0.6433850578289756
919,Burundi,BDI,1994,645157,170898,25750,217095,413743,0.6413059146843326
920,Burundi,BDI,1995,637622,168680,25326,213791,407797,0.639559174557967
921,Burundi,BDI,1996,637895,168636,25258,212537,406431,0.63714404408249
922,Burundi,BDI,1990,610705,162385,24604,209041,396030,0.6484800353689588
923,Burundi,BDI,1998,670583,177528,26560,218293,422381,0.6298713209252248
924,Burundi,BDI,1997,653029,172727,25855,215252,413834,0.633714582353923
925,Burundi,BDI,2002,738736,196559,29549,231449,457557,0.6193782352558965
926,Burundi,BDI,2001,717889,190645,28592,226987,446224,0.6215779876833326
927,Burundi,BDI,2004,791044,211487,31988,243592,487067,0.6157268116564945
928,Burundi,BDI,1999,685403,181612,27168,220545,429325,0.6263833102568853
929,Burundi,BDI,2000,700914,185918,27838,223494,437250,0.623828315599346
930,Cambodia,KHM,2019,1963974,741908,51751,465080,1258739,0.6409142890893668
931,Cambodia,KHM,2006,1672267,563289,38940,357696,959925,0.5740261573062196
932,Cambodia,KHM,2007,1691198,577155,39978,364590,981723,0.5804896883747497
933,Cambodia,KHM,2008,1709585,591521,41014,371238,1003773,0.5871442484579591
934,Cambodia,KHM,2009,1728993,605859,42046,378484,1026389,0.593633982323815
935,Cambodia,KHM,2010,1748744,619605,43067,386462,1049134,0.5999357252976993
936,Cambodia,KHM,2011,1770286,633090,44072,395031,1072193,0.6056608932116053
937,Cambodia,KHM,2012,1791465,646906,45060,403532,1095498,0.6115095745660675
938,Cambodia,KHM,2014,1836164,674404,46975,420563,1141942,0.6219172143664727
939,Cambodia,KHM,2016,1885387,700498,48882,438667,1188047,0.6301342907318233
940,Cambodia,KHM,2017,1912735,713926,49891,448504,1212321,0.6338154527417547
941,Cambodia,KHM,2018,1938929,727655,50845,457286,1235786,0.6373549521411047
942,Cambodia,KHM,2005,1652826,550448,37905,350473,938826,0.5680126038675577
943,Cambodia,KHM,2013,1813643,660773,46025,412011,1118809,0.6168849106466928
944,Cambodia,KHM,2015,1860107,687477,47912,429336,1164725,0.6261602155144839
945,Cambodia,KHM,2004,1633157,538426,36881,343427,918734,0.5625509366215251
946,Cambodia,KHM,2002,1590001,514400,34846,329208,878454,0.5524864449770787
947,Cambodia,KHM,2003,1612072,526458,35861,336442,898761,0.5575191430655703
948,Cambodia,KHM,1990,1228882,374453,25182,245032,644667,0.5245963404134816
949,Cambodia,KHM,1991,1261564,385294,25834,251686,662814,0.52539070550523
950,Cambodia,KHM,1992,1295287,396605,26524,258657,681786,0.5263590231354133
951,Cambodia,KHM,1994,1356010,418073,27848,271588,717509,0.5291325285211761
952,Cambodia,KHM,1995,1385291,428682,28537,278222,735441,0.5308927871472492
953,Cambodia,KHM,1993,1326859,407609,27199,265157,699965,0.5275353296770795
954,Cambodia,KHM,1997,1446167,451933,30104,292030,774067,0.5352542272088908
955,Cambodia,KHM,1998,1478638,464864,31008,299425,795297,0.537857812392215
956,Cambodia,KHM,1999,1510888,477908,31954,307000,816862,0.5406502665981859
957,Cambodia,KHM,2000,1539690,490442,32907,314552,837901,0.5442011054173242
958,Cambodia,KHM,2001,1566247,502418,33861,322018,858297,0.5479959418916684
959,Cambodia,KHM,1996,1414840,439812,29280,284966,754058,0.5329634446297815
960,Cameroon,CMR,2011,2263573,654356,97750,738642,1490748,0.6585818084948001
961,Cameroon,CMR,2007,1951681,562966,83934,635245,1282145,0.6569439370470892
962,Cameroon,CMR,2008,2026772,584495,87235,660071,1331801,0.6571044991740561
963,Cameroon,CMR,2009,2103597,606836,90638,685605,1383079,0.6574828733830672
964,Cameroon,CMR,2010,2183237,630067,94141,711736,1435944,0.6577132945255142
965,Cameroon,CMR,2012,2346814,679762,101477,766496,1547735,0.6595047583660231
966,Cameroon,CMR,2019,2980642,874030,131374,993098,1998502,0.6704938063678899
967,Cameroon,CMR,2014,2515966,733065,109260,823867,1666192,0.6622474230573863
968,Cameroon,CMR,2015,2604870,760464,113343,854653,1728460,0.6635494285703317
969,Cameroon,CMR,2016,2694538,789305,117586,885653,1792544,0.6652509632449051
970,Cameroon,CMR,2017,2788275,818817,122013,918435,1859265,0.6668155042095919
971,Cameroon,CMR,2018,2883318,847010,126608,953989,1927607,0.6685377748829647
972,Cameroon,CMR,2006,1879629,542103,80713,611436,1234252,0.656646604196892
973,Cameroon,CMR,2013,2430502,706080,105308,794791,1606179,0.660842492620866
974,Cameroon,CMR,2005,1809451,521804,77585,587938,1187327,0.6561807973799788
975,Cameroon,CMR,1993,1117161,322347,47671,358087,728105,0.6517458092432514
976,Cameroon,CMR,2003,1675578,482193,71597,542760,1096550,0.654430888923106
977,Cameroon,CMR,1991,1031970,298971,44267,332572,675810,0.6548736881886101
978,Cameroon,CMR,1992,1073166,310271,45909,344764,700944,0.6531552434572098
979,Cameroon,CMR,2004,1741513,501826,74545,565229,1141600,0.6555219513147476
980,Cameroon,CMR,1994,1163632,335219,49554,372477,757250,0.6507641591155967
981,Cameroon,CMR,1995,1212172,348866,51557,387776,788199,0.65023693007263
982,Cameroon,CMR,1996,1262708,363233,53684,404205,821122,0.6502865270513848
983,Cameroon,CMR,1990,993632,288494,42750,321237,652481,0.6566626276126373
984,Cameroon,CMR,1998,1372496,393881,58282,440872,893035,0.6506649199706228
985,Cameroon,CMR,1999,1430552,410122,60740,460376,931238,0.6509641033670919
986,Cameroon,CMR,2000,1489062,426985,63301,480263,970549,0.6517854864337415
987,Cameroon,CMR,2001,1549872,444618,65969,500400,1010987,0.6523035450669474
988,Cameroon,CMR,2002,1611891,463085,68742,521249,1053076,0.6533171287636695
989,Cameroon,CMR,1997,1316400,378262,55931,421859,856052,0.6502977818292313
990,Canada,CAN,2007,4335706,1326752,282547,1149577,2758876,0.6363152852153721
991,Canada,CAN,2008,4465233,1430629,285712,1150607,2866948,0.6420601119807186
992,Canada,CAN,2009,4583894,1523002,288800,1154248,2966050,0.6470590288518888
993,Canada,CAN,2010,4661462,1575803,291810,1162045,3029658,0.6499372943509998
994,Canada,CAN,2011,4711641,1598293,294659,1175728,3068680,0.6512974991091214
995,Canada,CAN,2012,4763396,1618718,297252,1193428,3109398,0.652769158810227
996,Canada,CAN,2015,4905291,1670328,303831,1240746,3214905,0.6553953679812268
997,Canada,CAN,2014,4863541,1654509,301807,1228891,3185207,0.6549152150665534
998,Canada,CAN,2016,4941197,1686727,305708,1247725,3240160,0.6557439422067163
999,Canada,CAN,2017,4977891,1700812,307484,1255399,3263695,0.6556381005530254
1000,Canada,CAN,2018,5009540,1708271,309181,1266070,3283522,0.6554537941607413
1001,Canada,CAN,2006,4224003,1238576,279306,1149064,2666946,0.631378812941184
1002,Canada,CAN,2013,4814767,1637348,299624,1211603,3148575,0.6539413018324667
1003,Canada,CAN,2005,4158435,1192784,276047,1147295,2616126,0.6291131158717161
1004,Canada,CAN,2019,5039382,1710235,310803,1281759,3302797,0.6553972292634295
1005,Canada,CAN,2003,4096815,1162992,266187,1156863,2586042,0.6312323109537531
1006,Canada,CAN,1990,3813853,1306574,227217,983624,2517415,0.6600713241962918
1007,Canada,CAN,1991,3873558,1327723,230138,1003380,2561241,0.6612114753412753
1008,Canada,CAN,1992,3929312,1346886,232891,1022374,2602151,0.6622408706664169
1009,Canada,CAN,1993,3982449,1364515,235478,1041366,2641359,0.6632499248577948
1010,Canada,CAN,1994,4032978,1381121,237979,1059560,2678660,0.6641890930225753
1011,Canada,CAN,1995,4081320,1396850,240392,1076856,2714098,0.6650049493791225
1012,Canada,CAN,2004,4126181,1177411,271756,1149724,2598891,0.629853852751491
1013,Canada,CAN,1997,4073044,1307848,244944,1114852,2667644,0.6549509408687949
1014,Canada,CAN,1998,4030818,1220757,247141,1134167,2602065,0.6455426665257523
1015,Canada,CAN,1999,4000087,1148715,249421,1152052,2550188,0.637533133654343
1016,Canada,CAN,2000,4006692,1124956,251777,1164722,2541455,0.6343025618140851
1017,Canada,CAN,2001,4039231,1136895,255290,1169308,2561493,0.6341536297379378
1018,Canada,CAN,2002,4068995,1149542,260406,1164923,2574871,0.632802694522849
1019,Canada,CAN,1996,4098443,1377180,242723,1095095,2714998,0.6624462021309068
1020,Cape Verde,CPV,2006,53438,14668,2531,20313,37512,0.7019723792058086
1021,Cape Verde,CPV,2007,54298,14896,2596,20786,38278,0.7049615087111865
1022,Cape Verde,CPV,2008,55142,15114,2662,21236,39012,0.7074824997279751
1023,Cape Verde,CPV,2009,55963,15328,2726,21682,39736,0.7100405625145185
1024,Cape Verde,CPV,2010,56833,15545,2789,22152,40486,0.7123678144739852
1025,Cape Verde,CPV,2011,57729,15780,2851,22648,41279,0.7150478962046805
1026,Cape Verde,CPV,2015,61483,16821,3092,24622,44535,0.7243465673438186
1027,Cape Verde,CPV,2013,59589,16303,2973,23635,42911,0.7201161288157211
1028,Cape Verde,CPV,2014,60530,16569,3033,24126,43728,0.7224186353874112
1029,Cape Verde,CPV,2016,62422,17071,3148,25113,45332,0.726218320463939
1030,Cape Verde,CPV,2017,63384,17312,3204,25601,46117,0.7275810930203206
1031,Cape Verde,CPV,2018,64233,17516,3258,26025,46799,0.728581881587346
1032,Cape Verde,CPV,2005,52499,14425,2465,19801,36691,0.6988895026571935
1033,Cape Verde,CPV,2012,58636,16036,2913,23130,42079,0.7176308070127567
1034,Cape Verde,CPV,2019,64993,17690,3312,26358,47360,0.728693859338698
1035,Cape Verde,CPV,2004,51504,14164,2399,19242,35805,0.6951887232059646
1036,Cape Verde,CPV,2002,49331,13588,2266,18060,33914,0.6874784618191401
1037,Cape Verde,CPV,2003,50449,13885,2332,18662,34879,0.6913714840730243
1038,Cape Verde,CPV,1990,34931,9709,1594,11928,23231,0.6650539635280982
1039,Cape Verde,CPV,1991,35866,9950,1633,12288,23871,0.6655606981542408
1040,Cape Verde,CPV,1992,36895,10221,1675,12684,24580,0.6662149342729368
1041,Cape Verde,CPV,1994,39191,10840,1770,13558,26168,0.6677043198693577
1042,Cape Verde,CPV,1995,40423,11180,1823,14027,27030,0.6686787225094625
1043,Cape Verde,CPV,1993,38007,10519,1721,13104,25344,0.6668245323229931
1044,Cape Verde,CPV,1997,43003,11888,1939,15094,28921,0.6725344743389996
1045,Cape Verde,CPV,1998,44349,12244,2002,15684,29930,0.6748742925432366
1046,Cape Verde,CPV,1999,45673,12596,2067,16290,30953,0.6777089308781994
1047,Cape Verde,CPV,2000,46942,12942,2133,16867,31942,0.6804567338417622
1048,Cape Verde,CPV,2001,48161,13273,2199,17459,32931,0.6837690247295529
1049,Cape Verde,CPV,1996,41700,11532,1880,14534,27946,0.670167865707434
1050,Central African Republic,CAF,2012,593422,178190,20757,213993,412940,0.6958623037231515
1051,Central African Republic,CAF,2007,527950,157001,18416,190932,366349,0.6939085140638318
1052,Central African Republic,CAF,2008,540938,161082,18911,195438,375431,0.6940370245758294
1053,Central African Republic,CAF,2010,571977,170789,20069,206490,397348,0.6946922690947364
1054,Central African Republic,CAF,2011,586485,175511,20574,211797,407882,0.6954687673171522
1055,Central African Republic,CAF,2013,594776,179290,20712,214025,414027,0.696105760824243
1056,Central African Republic,CAF,2006,516757,153487,17993,187152,358632,0.6940051126544972
1057,Central African Republic,CAF,2015,614048,186397,21261,220075,427733,0.6965790947938924
1058,Central African Republic,CAF,2016,629495,191759,21760,224840,438359,0.6963661347588146
1059,Central African Republic,CAF,2017,644781,196885,22268,229634,448787,0.696030124957156
1060,Central African Republic,CAF,2018,662589,201943,22887,236125,460955,0.6956876736559164
1061,Central African Republic,CAF,2019,682347,207056,23595,243707,474358,0.6951858804977527
1062,Central African Republic,CAF,2014,600726,181811,20844,215660,418315,0.6963490842746943
1063,Central African Republic,CAF,2004,494817,146631,17197,179704,343532,0.694260706483407
1064,Central African Republic,CAF,2009,555726,165732,19471,200569,385772,0.6941766266109558
1065,Central African Republic,CAF,2005,506211,150192,17604,183536,351332,0.6940426027881654
1066,Central African Republic,CAF,1991,342019,101324,12015,126787,240126,0.7020838023618571
1067,Central African Republic,CAF,1992,353226,104553,12388,130748,247689,0.7012196157700735
1068,Central African Republic,CAF,1993,363842,107668,12745,134514,254927,0.7006530307111328
1069,Central African Republic,CAF,1994,373792,110565,13074,138007,261646,0.6999775276089376
1070,Central African Republic,CAF,1995,384085,113562,13416,141614,268592,0.6993035395810823
1071,Central African Republic,CAF,1996,395388,116837,13795,145607,276239,0.6986529687294506
1072,Central African Republic,CAF,1990,332041,98424,11681,123261,233366,0.7028228441668348
1073,Central African Republic,CAF,1998,420706,124115,14647,154728,293490,0.6976130599516052
1074,Central African Republic,CAF,1999,433183,127708,15067,159215,301990,0.6971418545972488
1075,Central African Republic,CAF,2003,482223,142662,16753,175661,335076,0.6948569437791229
1076,Central African Republic,CAF,2000,444728,131087,15457,163320,309864,0.6967494738356929
1077,Central African Republic,CAF,2001,456948,134792,15879,167493,318164,0.696280539579996
1078,Central African Republic,CAF,2002,469488,138676,16311,171565,326552,0.6955491940156084
1079,Central African Republic,CAF,1997,407618,120361,14205,150015,284581,0.6981561167563748
1080,Chad,TCD,2007,1060746,285832,40145,349743,675720,0.6370233778868833
1081,Chad,TCD,2008,1094937,296976,41537,360785,699298,0.6386650556150719
1082,Chad,TCD,2009,1131532,308828,42999,372496,724323,0.6401259531325671
1083,Chad,TCD,2010,1170430,321376,44552,384883,750811,0.6414830446929761
1084,Chad,TCD,2011,1211884,334894,46181,397518,778593,0.6424649553917702
1085,Chad,TCD,2012,1254928,349616,47895,409627,807138,0.6431747478739817
1086,Chad,TCD,2015,1398043,398318,53620,450323,902261,0.6453742839097224
1087,Chad,TCD,2014,1347619,381638,51604,435420,868662,0.6445901994554841
1088,Chad,TCD,2016,1450592,415841,55735,466558,938134,0.6467249233416426
1089,Chad,TCD,2017,1505957,433700,57956,483542,975198,0.6475603221074705
1090,Chad,TCD,2018,1565330,451345,60284,502678,1014307,0.6479828534558209
1091,Chad,TCD,2006,1027872,275442,38827,339071,653340,0.6356238909124872
1092,Chad,TCD,2013,1300079,365297,49703,422047,837047,0.6438431818374114
1093,Chad,TCD,2005,995705,265796,37574,328789,632159,0.6348858346598641
1094,Chad,TCD,2019,1629263,469250,62717,523661,1055628,0.647917493983476
1095,Chad,TCD,2003,934783,248034,35227,308762,592023,0.6333266651190704
1096,Chad,TCD,1990,619141,164253,23815,203085,391153,0.631767238803439
1097,Chad,TCD,1991,636251,169027,24498,208492,402017,0.6318528379523176
1098,Chad,TCD,1992,654379,174037,25209,214254,413500,0.6318968059794094
1099,Chad,TCD,1993,673530,179300,25950,220298,425548,0.6318174394607515
1100,Chad,TCD,1994,693788,184831,26723,226603,438157,0.6315430650285101
1101,Chad,TCD,1995,715301,190655,27529,233283,451467,0.6311566739037132
1102,Chad,TCD,2004,964878,256698,36370,318754,611822,0.6340926003080182
1103,Chad,TCD,1997,765369,203286,29243,250818,483347,0.6315215275246319
1104,Chad,TCD,1998,793338,210074,30147,261170,501391,0.6320017445275532
1105,Chad,TCD,1999,821951,217113,31082,271498,519693,0.6322676169260698
1106,Chad,TCD,2000,850101,224365,32056,280939,537360,0.6321131253815723
1107,Chad,TCD,2001,878006,231870,33070,289953,554893,0.6319922642897656
1108,Chad,TCD,2002,906428,239760,34127,299237,573124,0.6322884994726553
1109,Chad,TCD,1996,739081,196799,28371,241232,466402,0.6310566771436419
1110,Chile,CHL,2006,2442288,947953,171748,693542,1813243,0.7424361909815714
1111,Chile,CHL,2007,2452947,958455,174271,685906,1818632,0.7414069688419684
1112,Chile,CHL,2008,2458865,968177,176700,673915,1818792,0.7396876201011442
1113,Chile,CHL,2009,2466108,977333,179015,664894,1821242,0.7385086135724794
1114,Chile,CHL,2010,2480903,986122,181182,665358,1832662,0.7387076399198195
1115,Chile,CHL,2011,2501338,993389,183213,673852,1850454,0.7397856667111762
1116,Chile,CHL,2015,2577153,1014704,190362,708110,1913176,0.7423602711984892
1117,Chile,CHL,2013,2538119,1002939,186884,691306,1881129,0.7411508286254506
1118,Chile,CHL,2014,2555575,1007546,188534,699703,1895783,0.7418224861332576
1119,Chile,CHL,2016,2608636,1025078,192960,718086,1936124,0.7421978382572348
1120,Chile,CHL,2017,2643142,1037139,195810,727911,1960860,0.7418670657876119
1121,Chile,CHL,2018,2667663,1047956,197736,733331,1979023,0.7418564488842856
1122,Chile,CHL,2005,2420991,936525,169112,691190,1796827,0.742186567401531
1123,Chile,CHL,2012,2520018,998615,185119,682703,1866437,0.7406443128580827
1124,Chile,CHL,2019,2684263,1057704,199007,734650,1991361,0.7418650855001913
1125,Chile,CHL,2004,2388504,920708,165457,681172,1767337,0.7399347038983397
1126,Chile,CHL,2002,2306735,876103,155276,658142,1689521,0.7324296028802615
1127,Chile,CHL,2003,2349637,899405,160533,669898,1729836,0.736214147121449
1128,Chile,CHL,1990,1950221,711545,124539,559826,1395910,0.7157701614329863
1129,Chile,CHL,1991,1977937,723211,126585,568765,1418561,0.7171922058184866
1130,Chile,CHL,1992,2005896,735012,128601,577228,1440841,0.7183029429242593
1131,Chile,CHL,1994,2061887,759019,132737,594399,1486155,0.720774222835684
1132,Chile,CHL,1995,2090696,771358,134942,602702,1509002,0.721770166490011
1133,Chile,CHL,1993,2033863,746917,130639,585779,1463335,0.7194855307363377
1134,Chile,CHL,1997,2145220,796717,139668,616157,1552542,0.7237215763418204
1135,Chile,CHL,1998,2171085,809845,142082,621034,1572961,0.7245045679925014
1136,Chile,CHL,1999,2199049,823309,144548,627382,1595239,0.7254222166036318
1137,Chile,CHL,2000,2229500,836998,147081,635908,1619987,0.7266144875532631
1138,Chile,CHL,2001,2265390,854187,150533,646684,1651404,0.7289711705269292
1139,Chile,CHL,1996,2118503,783912,137273,610081,1531266,0.72280567929335
1140,China,CHN,2011,154826809,46952118,2937596,44971037,94860751,0.6126894406252343
1141,China,CHN,2007,153780187,46647395,2825623,43425689,92898707,0.6041006244842192
1142,China,CHN,2008,153988167,46875241,2857860,43571376,93304477,0.6059197847325503
1143,China,CHN,2009,154231491,47067750,2887343,43820117,93775210,0.6080159725616606
1144,China,CHN,2010,154569565,47148263,2913971,44288056,94350290,0.6104066476476142
1145,China,CHN,2012,154901820,46483949,2959080,45728981,95172010,0.6144021419503012
1146,China,CHN,2006,153533835,46446794,2790858,43233810,92471462,0.6022871896608327
1147,China,CHN,2014,155238787,45551974,2996644,47318196,95866814,0.6175442094893463
1148,China,CHN,2015,155864085,45534202,3013114,48058838,96606154,0.6198102276095228
1149,China,CHN,2016,157595907,46675118,3027832,48704715,98407665,0.6244303349832556
1150,China,CHN,2017,159422086,47918741,3041111,49303509,100263361,0.6289176331565502
1151,China,CHN,2018,160124123,48116799,3053078,49776887,100946764,0.6304282084967298
1152,China,CHN,2013,154983501,45945330,2978767,46524347,95448444,0.6158619684297879
1153,China,CHN,2005,153204362,46336197,2754023,42847068,91937288,0.6000957596755633
1154,China,CHN,2019,160162694,47842153,3063489,50056236,100961878,0.6303707528795688
1155,China,CHN,2003,153372568,47439378,2673114,41610440,91722932,0.598040009345087
1156,China,CHN,1990,132628079,41687414,2176802,34143548,78007764,0.5881692970913045
1157,China,CHN,1991,135576350,42141042,2215136,35444104,79800282,0.5886003126651514
1158,China,CHN,1992,138328208,42611131,2251075,36577849,81440055,0.5887451025173405
1159,China,CHN,1993,140873884,43106858,2285649,37546803,82939310,0.5887486569192626
1160,China,CHN,1994,143168399,43640085,2319929,38359877,84319891,0.5889560237381715
1161,China,CHN,1995,145180626,44215845,2354354,39008329,85578528,0.589462453481913
1162,China,CHN,2004,153118179,46657653,2714757,42275249,91647659,0.5985419863176403
1163,China,CHN,1997,148596645,46034680,2426420,39447716,87908816,0.5915935450628781
1164,China,CHN,1998,150119538,47160311,2464329,39401966,89026606,0.5930381027418297
1165,China,CHN,1999,151525581,48180393,2503657,39430334,90114384,0.5947139974998676
1166,China,CHN,2000,152752326,48860682,2544244,39716857,91121783,0.5965328671983692
1167,China,CHN,2001,153492720,48886401,2586648,40273630,91746679,0.5977265827330442
1168,China,CHN,2002,153602920,48302618,2630003,40923615,91856236,0.5980110013533597
1169,China,CHN,1996,146952605,44998243,2389811,39379009,86767063,0.590442496749207
1170,Colombia,COL,2007,5149999,2100111,323695,1047065,3470871,0.6739556648457602
1171,Colombia,COL,2009,4919533,1842687,332861,1004879,3180427,0.6464896159859076
1172,Colombia,COL,2010,4893360,1803861,337075,998668,3139604,0.6416049503817418
1173,Colombia,COL,2011,4928036,1823601,341097,1003564,3168262,0.6429056118908222
1174,Colombia,COL,2012,4961059,1843849,344979,1009438,3198266,0.644674050439634
1175,Colombia,COL,2015,5070548,1912109,356177,1037211,3305497,0.6519013329525724
1176,Colombia,COL,2014,5026094,1887011,352350,1024579,3263940,0.6493989169323137
1177,Colombia,COL,2006,5235711,2208969,318800,1060531,3588300,0.6853510440129335
1178,Colombia,COL,2016,5283819,2095921,362155,1065829,3523905,0.6669238669984722
1179,Colombia,COL,2017,5527347,2295760,369760,1099471,3764991,0.6811569818214779
1180,Colombia,COL,2018,5600004,2333609,374793,1121956,3830358,0.6839920114342776
1181,Colombia,COL,2019,5635241,2348147,377487,1141467,3867101,0.6862352470817131
1182,Colombia,COL,2013,4990573,1864764,348708,1015680,3229152,0.6470503487274908
1183,Colombia,COL,2005,5228511,2235096,313734,1055518,3604348,0.6893641421047024
1184,Colombia,COL,2008,5025782,1960081,328406,1024889,3313376,0.6592757107252165
1185,Colombia,COL,2003,5069918,2165128,303011,1016481,3484620,0.6873128914511043
1186,Colombia,COL,1990,3618537,1421881,226140,672044,2320065,0.6411610548683073
1187,Colombia,COL,1991,3704268,1454662,231816,693644,2380122,0.6425350433607936
1188,Colombia,COL,1992,3791767,1489387,237585,715826,2442798,0.6442373700704711
1189,Colombia,COL,1993,3882523,1525852,243470,738513,2507835,0.6459292063434009
1190,Colombia,COL,1994,3977595,1563667,249475,762644,2575786,0.6475737223121006
1191,Colombia,COL,1995,4072694,1602453,255567,787678,2645698,0.6496186553666934
1192,Colombia,COL,2004,5153110,2201594,308457,1036969,3547020,0.6883260788145411
1193,Colombia,COL,1997,4346312,1761903,267877,849322,2879102,0.6624241425834132
1194,Colombia,COL,1998,4512567,1872510,274029,883888,3030427,0.6715527991052542
1195,Colombia,COL,1999,4670284,1974224,280094,917565,3171883,0.67916276611872
1196,Colombia,COL,2000,4792386,2042887,286032,946271,3275190,0.6834153175474597
1197,Colombia,COL,2001,4888092,2085783,291840,970679,3348302,0.6849916081775875
1198,Colombia,COL,2002,4981457,2126503,297482,994457,3418442,0.6862333650576529
1199,Colombia,COL,1996,4192223,1665045,261707,816377,2743129,0.6543375674433349
1200,Comoros,COM,2006,63889,18937,3187,20279,42403,0.6636979761774328
1201,Comoros,COM,2007,65022,19280,3256,20672,43208,0.6645135492602504
1202,Comoros,COM,2008,66164,19625,3327,21072,44024,0.665376942143764
1203,Comoros,COM,2009,67344,19982,3399,21495,44876,0.6663696840104538
1204,Comoros,COM,2010,68558,20367,3472,21960,45799,0.6680329064441787
1205,Comoros,COM,2011,69848,20805,3546,22470,46821,0.6703269957622265
1206,Comoros,COM,2015,75345,22863,3854,24744,51461,0.6830048443825071
1207,Comoros,COM,2013,72549,21816,3698,23580,49094,0.6767012639733145
1208,Comoros,COM,2014,73913,22348,3775,24163,50286,0.6803404002002355
1209,Comoros,COM,2016,76807,23413,3933,25340,52686,0.6859531032327782
1210,Comoros,COM,2017,78260,23942,4013,25942,53897,0.6886915410171224
1211,Comoros,COM,2018,79675,24385,4092,26579,55056,0.6910072168183244
1212,Comoros,COM,2005,62735,18582,3119,19872,41573,0.6626763369729816
1213,Comoros,COM,2012,71187,21294,3621,23019,47934,0.6733532807956509
1214,Comoros,COM,2019,81080,24787,4173,27271,56231,0.6935249136655155
1215,Comoros,COM,2004,61621,18215,3053,19482,40750,0.6613005306632479
1216,Comoros,COM,2002,59424,17490,2925,18764,39179,0.6593127355950458
1217,Comoros,COM,1990,46445,13542,2210,14465,30217,0.6505974808913769
1218,Comoros,COM,1991,47607,13892,2273,14843,31008,0.6513327871951604
1219,Comoros,COM,1992,48763,14233,2335,15228,31796,0.6520517605561594
1220,Comoros,COM,1993,49877,14568,2396,15604,32568,0.6529662970908435
1221,Comoros,COM,1994,50986,14897,2456,15982,33335,0.6538069273918331
1222,Comoros,COM,1995,52067,15223,2515,16341,34079,0.6545220581174256
1223,Comoros,COM,2003,60518,17849,2988,19116,39953,0.6601837469843683
1224,Comoros,COM,1997,54160,15850,2629,17037,35516,0.6557607090103398
1225,Comoros,COM,1998,55193,16161,2686,17362,36209,0.6560433388291994
1226,Comoros,COM,1999,56241,16477,2744,17698,36919,0.6564428086271581
1227,Comoros,COM,2000,57302,16802,2803,18058,37663,0.6572719974869987
1228,Comoros,COM,2001,58365,17140,2863,18407,38410,0.6580998886318855
1229,Comoros,COM,1996,53126,15540,2572,16699,34811,0.6552535481685051
1230,Congo,COG,2007,448409,131070,18304,183205,332579,0.7416867190444438
1231,Congo,COG,2008,460227,134845,18855,187695,341395,0.7417969827932738
1232,Congo,COG,2009,472361,138736,19417,192238,350391,0.7417864726342775
1233,Congo,COG,2010,485229,142753,19993,197103,359849,0.741606540416999
1234,Congo,COG,2011,498140,146915,20578,201747,369240,0.7412374031396796
1235,Congo,COG,2012,510990,151241,21176,205783,378200,0.7401319008199769
1236,Congo,COG,2015,552660,165007,23055,219612,407674,0.7376578728332067
1237,Congo,COG,2014,537993,160300,22409,214368,397077,0.7380709414434761
1238,Congo,COG,2016,568411,170093,23719,225716,419528,0.7380715714509396
1239,Congo,COG,2017,584782,175278,24407,232153,431838,0.7384598021142922
1240,Congo,COG,2018,601294,180019,25117,239232,444368,0.739019514580222
1241,Congo,COG,2006,436630,127383,17763,178728,323874,0.7417584682683279
1242,Congo,COG,2013,524274,155707,21784,209969,387460,0.7390410357942603
1243,Congo,COG,2019,618360,184415,25850,246802,457067,0.7391600362248528
1244,Congo,COG,2005,424948,123777,17231,174027,315035,0.7413495298248256
1245,Congo,COG,2003,402503,116634,16196,165160,297990,0.7403423080076422
1246,Congo,COG,2004,413549,120193,16707,169486,306386,0.7408698848262237
1247,Congo,COG,1990,269954,78526,10623,107146,196295,0.7271424020388659
1248,Congo,COG,1991,278939,81241,10996,110693,202930,0.7275067308623032
1249,Congo,COG,1992,288272,84011,11380,114422,209813,0.727829966143087
1250,Congo,COG,1994,307349,89638,12177,122268,224083,0.7290832246078562
1251,Congo,COG,1995,317130,92501,12590,126374,231465,0.7298741840885441
1252,Congo,COG,1993,297743,86813,11774,118306,216893,0.7284570921902446
1253,Congo,COG,1997,337608,98002,13418,136016,247436,0.7329091727684178
1254,Congo,COG,1998,348051,100617,13821,141219,255657,0.7345389037813423
1255,Congo,COG,1999,359135,103473,14261,146650,264384,0.7361688501538419
1256,Congo,COG,2000,370065,106517,14724,151713,272954,0.7375839379568454
1257,Congo,COG,2001,380790,109742,15202,156242,281186,0.7384280049371045
1258,Congo,COG,2002,391544,113136,15694,160708,289538,0.7394775555237726
1259,Congo,COG,1996,327448,95345,13014,130986,239345,0.7309404852068114
1260,Cook Islands,COK,2010,2095,761,54,609,1424,0.6797136038186158
1261,Cook Islands,COK,2006,2170,778,55,614,1447,0.6668202764976958
1262,Cook Islands,COK,2007,2167,780,55,616,1451,0.6695892939547762
1263,Cook Islands,COK,2008,2149,776,55,615,1446,0.6728711028385296
1264,Cook Islands,COK,2009,2123,769,55,612,1436,0.6764013188883655
1265,Cook Islands,COK,2011,2071,754,54,606,1414,0.6827619507484307
1266,Cook Islands,COK,2019,2075,770,55,625,1450,0.6987951807228916
1267,Cook Islands,COK,2013,2052,751,54,606,1411,0.6876218323586745
1268,Cook Islands,COK,2014,2052,753,54,608,1415,0.6895711500974658
1269,Cook Islands,COK,2015,2054,756,54,611,1421,0.6918208373904576
1270,Cook Islands,COK,2016,2056,757,54,614,1425,0.6930933852140078
1271,Cook Islands,COK,2017,2059,758,54,618,1430,0.6945118989800875
1272,Cook Islands,COK,2018,2066,763,55,621,1439,0.6965150048402711
1273,Cook Islands,COK,2012,2058,751,54,606,1411,0.685617103984451
1274,Cook Islands,COK,2005,2152,770,55,608,1433,0.6658921933085502
1275,Cook Islands,COK,2004,2124,759,54,600,1413,0.6652542372881356
1276,Cook Islands,COK,2002,2064,738,53,583,1374,0.6656976744186046
1277,Cook Islands,COK,1990,2004,708,48,523,1279,0.6382235528942116
1278,Cook Islands,COK,1991,2020,715,49,530,1294,0.6405940594059406
1279,Cook Islands,COK,1992,2033,720,49,537,1306,0.6424003935071323
1280,Cook Islands,COK,1993,2044,725,50,542,1317,0.6443248532289628
1281,Cook Islands,COK,1994,2050,728,50,548,1326,0.646829268292683
1282,Cook Islands,COK,1995,2055,730,51,553,1334,0.6491484184914842
1283,Cook Islands,COK,2003,2092,748,54,591,1393,0.6658699808795411
1284,Cook Islands,COK,1997,2048,730,51,560,1341,0.65478515625
1285,Cook Islands,COK,1998,2040,729,51,563,1343,0.6583333333333333
1286,Cook Islands,COK,1999,2034,728,52,566,1346,0.6617502458210422
1287,Cook Islands,COK,2000,2034,728,52,570,1350,0.6637168141592921
1288,Cook Islands,COK,2001,2042,731,52,576,1359,0.6655239960822723
1289,Cook Islands,COK,1996,2054,731,51,558,1340,0.6523855890944499
1290,Costa Rica,CRI,2007,530121,178514,38721,134713,351948,0.6639012602783139
1291,Costa Rica,CRI,2009,544010,184115,39956,140250,364321,0.6696954100108454
1292,Costa Rica,CRI,2010,550338,186718,40524,142895,370137,0.6725630430753464
1293,Costa Rica,CRI,2011,556618,189392,41063,145473,375928,0.6753788055722236
1294,Costa Rica,CRI,2012,563188,192317,41591,148085,381993,0.6782690682329879
1295,Costa Rica,CRI,2013,569810,195308,42098,150718,388124,0.6811463470279567
1296,Costa Rica,CRI,2016,587992,202917,43451,158297,404665,0.6882151457842964
1297,Costa Rica,CRI,2015,582172,200708,43032,155850,399590,0.6863779089341294
1298,Costa Rica,CRI,2006,522795,175642,38060,131886,345588,0.661039221874731
1299,Costa Rica,CRI,2017,593211,204952,43848,160605,409405,0.690150722087082
1300,Costa Rica,CRI,2018,598401,206892,44229,162929,414050,0.6919273196401744
1301,Costa Rica,CRI,2019,603549,208779,44597,165166,418542,0.6934681359757037
1302,Costa Rica,CRI,2014,576243,198176,42581,153318,394075,0.6838694786747952
1303,Costa Rica,CRI,2005,515236,172764,37368,129019,339151,0.658243989162248
1304,Costa Rica,CRI,2008,537244,181359,39354,137527,358240,0.6668106111934242
1305,Costa Rica,CRI,2003,498394,166713,35883,122844,325440,0.6529773632908903
1306,Costa Rica,CRI,2004,507077,169812,36642,125943,332397,0.6555158289569434
1307,Costa Rica,CRI,1991,358858,119129,25195,81903,226227,0.6304081280060637
1308,Costa Rica,CRI,1992,370868,123197,26053,84820,234070,0.6311409989538057
1309,Costa Rica,CRI,1993,383152,127359,26940,87937,242236,0.6322190671065269
1310,Costa Rica,CRI,1994,395581,131595,27852,91116,250563,0.6334050422037458
1311,Costa Rica,CRI,1995,408149,135856,28777,94407,259040,0.6346701817228512
1312,Costa Rica,CRI,1996,420728,140110,29708,97916,267734,0.6363588826985606
1313,Costa Rica,CRI,1990,347122,115162,24367,79099,218628,0.6298304342565438
1314,Costa Rica,CRI,1998,445335,148455,31570,105351,285376,0.6408119730090831
1315,Costa Rica,CRI,1999,457249,152471,32493,109184,294148,0.6432993839242951
1316,Costa Rica,CRI,2000,468366,156329,33397,112789,302515,0.6458944500668281
1317,Costa Rica,CRI,2001,478857,159982,34264,116215,310461,0.6483376039193329
1318,Costa Rica,CRI,2002,488881,163439,35092,119571,318102,0.6506736813253123
1319,Costa Rica,CRI,1997,433142,144323,30640,101555,276518,0.6384003398423612
1320,Cote d'Ivoire,CIV,2007,1929379,588696,89365,564260,1242321,0.6438968186136576
1321,Cote d'Ivoire,CIV,2008,1973651,601980,91521,576667,1270168,0.6435626156802798
1322,Cote d'Ivoire,CIV,2010,2065863,629688,95861,603510,1329059,0.6433432420252456
1323,Cote d'Ivoire,CIV,2011,2114074,644854,98066,619119,1362039,0.6442721494138804
1324,Cote d'Ivoire,CIV,2012,2165061,661387,100322,636819,1398528,0.6459531625205941
1325,Cote d'Ivoire,CIV,2013,2217934,678854,102652,656140,1437646,0.6481915151668174
1326,Cote d'Ivoire,CIV,2016,2379035,731790,110242,714296,1556328,0.6541845748381171
1327,Cote d'Ivoire,CIV,2015,2325201,714409,107587,694988,1516984,0.652409834676658
1328,Cote d'Ivoire,CIV,2017,2434027,749581,113016,734099,1596696,0.6559894364359968
1329,Cote d'Ivoire,CIV,2018,2493079,768535,115912,755631,1640078,0.6578523985802295
1330,Cote d'Ivoire,CIV,2019,2554853,788575,118918,778395,1685888,0.6598767130633347
1331,Cote d'Ivoire,CIV,2006,1885316,575614,87222,551587,1214423,0.6441482488877196
1332,Cote d'Ivoire,CIV,2014,2271416,696700,105062,675439,1477201,0.6503436622793887
1333,Cote d'Ivoire,CIV,2005,1841704,562574,85086,538675,1186335,0.6441507430075626
1334,Cote d'Ivoire,CIV,2009,2019137,615603,93686,589536,1298825,0.6432574907002349
1335,Cote d'Ivoire,CIV,2003,1754057,535774,80803,512799,1129376,0.6438650511357384
1336,Cote d'Ivoire,CIV,1991,1163686,356082,52300,336900,745282,0.6404493995802991
1337,Cote d'Ivoire,CIV,1992,1214795,371033,54578,351412,777023,0.6396330245020765
1338,Cote d'Ivoire,CIV,1993,1267294,386406,56941,366359,809706,0.6389251428634555
1339,Cote d'Ivoire,CIV,1994,1319770,402046,59372,381842,843260,0.6389446646006501
1340,Cote d'Ivoire,CIV,1995,1371933,417851,61848,397620,877319,0.6394765633598726
1341,Cote d'Ivoire,CIV,1996,1423671,433684,64344,413119,911147,0.6399982861208805
1342,Cote d'Ivoire,CIV,1990,1113901,341685,50124,322964,714773,0.6416844944030035
1343,Cote d'Ivoire,CIV,1998,1524344,464678,69311,443068,977057,0.640968836430622
1344,Cote d'Ivoire,CIV,1997,1474654,449350,66842,428252,944444,0.6404512516156332
1345,Cote d'Ivoire,CIV,2002,1709405,521908,78602,499373,1099883,0.6434303163966409
1346,Cote d'Ivoire,CIV,2001,1664555,507860,76353,485991,1070204,0.6429370011804957
1347,Cote d'Ivoire,CIV,2004,1798180,549345,82955,525716,1158016,0.6439933710751983
1348,Cote d'Ivoire,CIV,1999,1572169,479450,71714,457609,1008773,0.6416441235007178
1349,Cote d'Ivoire,CIV,2000,1618634,493747,74057,471941,1039745,0.642359545147328
1350,Croatia,HRV,2019,518613,174903,26507,168656,370066,0.713568691876216
1351,Croatia,HRV,2006,536691,176490,27618,173711,377819,0.7039786394778373
1352,Croatia,HRV,2007,534304,176202,27540,172668,376410,0.7044865844163622
1353,Croatia,HRV,2008,532077,175907,27460,171652,375019,0.7048209187767935
1354,Croatia,HRV,2009,530086,175638,27387,170842,373867,0.7052949898695683
1355,Croatia,HRV,2010,528535,175416,27320,170299,373035,0.705790534212493
1356,Croatia,HRV,2011,527112,175324,27260,169865,372449,0.706584179453323
1357,Croatia,HRV,2012,525821,175416,27191,169422,372029,0.7075202397774147
1358,Croatia,HRV,2014,523885,175754,27034,168628,371416,0.7089647537150329
1359,Croatia,HRV,2016,522169,175474,26844,168833,371151,0.7107871206448487
1360,Croatia,HRV,2017,521479,175224,26736,169427,371387,0.7121801644936805
1361,Croatia,HRV,2018,520224,175013,26621,169288,370922,0.7130043981054315
1362,Croatia,HRV,2005,539198,176893,27697,174785,379375,0.703591259611497
1363,Croatia,HRV,2013,524783,175609,27115,169002,371726,0.7083423052957127
1364,Croatia,HRV,2015,522660,175675,26939,168390,371004,0.7098381356905062
1365,Croatia,HRV,2004,542282,177414,27789,176001,381204,0.7029626651815845
1366,Croatia,HRV,2002,550005,178790,28016,179402,386208,0.7021899800910901
1367,Croatia,HRV,2003,545919,178054,27892,177608,383554,0.7025840829866702
1368,Croatia,HRV,1990,596466,188186,29800,196330,414316,0.6946179664892885
1369,Croatia,HRV,1991,595746,188002,29756,196142,413900,0.6947591758903963
1370,Croatia,HRV,1992,593685,187518,29666,195500,412684,0.6951228344997769
1371,Croatia,HRV,1994,587526,186164,29418,193588,409170,0.6964287537913216
1372,Croatia,HRV,1995,583683,185275,29247,192438,406960,0.6972277760359648
1373,Croatia,HRV,1993,590954,186897,29555,194670,411122,0.6956920504810865
1374,Croatia,HRV,1997,574074,183391,28871,189033,401295,0.699030090197431
1375,Croatia,HRV,1998,568843,182461,28682,186926,398069,0.6997871117338176
1376,Croatia,HRV,1999,563518,181504,28500,184795,394799,0.7005969640721326
1377,Croatia,HRV,2000,558714,180513,28322,183007,391842,0.7013284077363374
1378,Croatia,HRV,2001,554208,179586,28163,181228,388977,0.7018610341243721
1379,Croatia,HRV,1996,579116,184324,29065,190926,404315,0.6981589180751352
1380,Cuba,CUB,2011,1749275,532343,122483,520849,1175675,0.6720927241285676
1381,Cuba,CUB,2007,1764250,527020,122087,524309,1173416,0.6651075527844693
1382,Cuba,CUB,2008,1758476,528747,122267,519774,1170788,0.6657969741981125
1383,Cuba,CUB,2009,1753250,530194,122385,517495,1170074,0.6673743048623983
1384,Cuba,CUB,2010,1750183,531188,122440,518071,1171699,0.6694722780417819
1385,Cuba,CUB,2012,1749640,533935,122479,524327,1180741,0.6748479687249949
1386,Cuba,CUB,2018,1736982,533778,121218,538990,1193986,0.6873911186183852
1387,Cuba,CUB,2014,1750072,536684,122299,530720,1189703,0.6798023167046842
1388,Cuba,CUB,2019,1737027,533916,120796,543627,1198339,0.6898793167866706
1389,Cuba,CUB,2015,1747903,536960,122076,533151,1192187,0.6820670254585066
1390,Cuba,CUB,2016,1743926,535731,121838,534644,1192213,0.6836373791089759
1391,Cuba,CUB,2017,1739173,534237,121563,535927,1191727,0.6852262540874312
1392,Cuba,CUB,2006,1769731,525191,121842,528967,1176000,0.6645077698249056
1393,Cuba,CUB,2013,1750240,535523,122424,527736,1185683,0.6774402367675291
1394,Cuba,CUB,2005,1774187,523473,121495,532694,1177662,0.6637755772080395
1395,Cuba,CUB,1994,1746796,489216,114752,562583,1166551,0.6678232604150685
1396,Cuba,CUB,2003,1781943,520199,120500,540056,1180755,0.6626222050873681
1397,Cuba,CUB,2004,1778398,521910,121041,536015,1178966,0.6629370928217418
1398,Cuba,CUB,1991,1719103,478214,111999,559493,1149706,0.6687824987798869
1399,Cuba,CUB,1992,1728378,481813,113111,561643,1156567,0.6691632270255696
1400,Cuba,CUB,1993,1737976,485466,114003,562536,1162005,0.6685966894824785
1401,Cuba,CUB,1995,1755461,493072,115410,562400,1170882,0.6669940260706447
1402,Cuba,CUB,1996,1762906,496967,116053,561043,1174063,0.6659816235238861
1403,Cuba,CUB,1990,1709319,474744,110707,555903,1141354,0.6677243978449897
1404,Cuba,CUB,1998,1775526,505277,117472,556567,1179316,0.6642065506221818
1405,Cuba,CUB,1999,1780243,509327,118159,553412,1180898,0.6633352862502478
1406,Cuba,CUB,2000,1784151,512965,118800,550988,1182753,0.6629220284605956
1407,Cuba,CUB,2001,1785301,515878,119363,547784,1183025,0.6626473631057171
1408,Cuba,CUB,1997,1769499,501066,116758,559147,1176971,0.6651436367016879
1409,Cuba,CUB,2002,1784475,518205,119921,544043,1182169,0.6624743972316788
1410,Cyprus,CYP,2007,160804,72803,10861,35621,119285,0.7418036864754608
1411,Cyprus,CYP,2008,164183,74491,11153,36344,121988,0.7430001888137018
1412,Cyprus,CYP,2010,171119,77829,11730,37979,127538,0.7453175860073984
1413,Cyprus,CYP,2011,174704,79472,12009,38958,130439,0.74662858320359
1414,Cyprus,CYP,2012,178314,81106,12276,40024,133406,0.7481521361194298
1415,Cyprus,CYP,2013,181911,82699,12531,41110,136340,0.7494873866890952
1416,Cyprus,CYP,2016,191343,86625,13215,43773,143613,0.7505526724259576
1417,Cyprus,CYP,2015,188593,85614,13000,43049,141663,0.7511572539807946
1418,Cyprus,CYP,2006,157431,71125,10572,34893,116590,0.7405784121297584
1419,Cyprus,CYP,2017,193995,87548,13419,44488,145455,0.7497873656537539
1420,Cyprus,CYP,2018,197159,88713,13612,45683,148008,0.7507037467221886
1421,Cyprus,CYP,2019,200773,89938,13794,47436,151168,0.7529299258366414
1422,Cyprus,CYP,2014,185351,84215,12773,42131,139119,0.7505705391392548
1423,Cyprus,CYP,2005,154069,69471,10288,34100,113859,0.7390130396121218
1424,Cyprus,CYP,2009,167609,76174,11444,37106,124724,0.7441366513731363
1425,Cyprus,CYP,2003,147270,66146,9742,32461,108349,0.7357167108032865
1426,Cyprus,CYP,2004,150623,67813,10011,33258,111082,0.7374836512352031
1427,Cyprus,CYP,1991,116744,51328,7509,25459,84296,0.7220585212087988
1428,Cyprus,CYP,1992,118854,52391,7655,25797,85843,0.722255876958285
1429,Cyprus,CYP,1993,120973,53456,7804,26174,87434,0.7227563175253983
1430,Cyprus,CYP,1994,123147,54526,7958,26597,89081,0.7233712554914046
1431,Cyprus,CYP,1995,125415,55597,8119,27093,90809,0.7240680939281585
1432,Cyprus,CYP,1996,127759,56704,8285,27668,92657,0.725248319100807
1433,Cyprus,CYP,1990,114674,50294,7369,25145,82808,0.7221166088215288
1434,Cyprus,CYP,1998,132751,59081,8640,28888,96609,0.7277459303508071
1435,Cyprus,CYP,1999,135355,60324,8830,29552,98706,0.7292379298880721
1436,Cyprus,CYP,2000,138039,61607,9031,30229,100867,0.7307137837857417
1437,Cyprus,CYP,2001,140914,62991,9249,30938,103178,0.7322054586485374
1438,Cyprus,CYP,2002,144015,64522,9487,31676,105685,0.733847168697705
1439,Cyprus,CYP,1997,130234,57873,8459,28270,94602,0.7264001719980957
1440,Czechia,CZE,2007,1201907,373681,66592,386174,826447,0.6876131015128458
1441,Czechia,CZE,2008,1202024,374474,66763,386334,827571,0.6884812616054256
1442,Czechia,CZE,2009,1202466,375089,66873,386570,828532,0.6890273820631935
1443,Czechia,CZE,2010,1203373,375538,66916,387001,829455,0.6892750626779893
1444,Czechia,CZE,2011,1203801,375821,66899,387229,829949,0.6894403643127062
1445,Czechia,CZE,2012,1204130,375974,66851,387320,830145,0.6894147641865912
1446,Czechia,CZE,2019,1210908,376715,65972,390239,832926,0.687852421488668
1447,Czechia,CZE,2014,1205020,376120,66698,387352,830170,0.688926324874276
1448,Czechia,CZE,2015,1205821,376184,66585,387535,830304,0.6885798140851752
1449,Czechia,CZE,2016,1206227,375144,66438,388253,829835,0.6879592315542596
1450,Czechia,CZE,2017,1206698,374291,66286,389170,829747,0.6876177800907932
1451,Czechia,CZE,2018,1208128,375054,66130,389574,830758,0.6876407135667744
1452,Czechia,CZE,2006,1201623,372813,66391,385929,825133,0.6866820957987655
1453,Czechia,CZE,2013,1204272,376052,66786,387254,830092,0.689289462845603
1454,Czechia,CZE,2005,1201384,371996,66171,385662,823829,0.6857332876082918
1455,Czechia,CZE,1994,1203370,360856,62863,389489,813208,0.6757755303855008
1456,Czechia,CZE,2003,1201055,370348,65665,385186,821199,0.6837313861563376
1457,Czechia,CZE,2004,1201039,371221,65927,385319,822467,0.6847962472492567
1458,Czechia,CZE,1991,1197454,356521,61724,384854,803099,0.6706721093252851
1459,Czechia,CZE,1992,1199711,357976,62074,386509,806559,0.6722944109039594
1460,Czechia,CZE,1993,1201552,359458,62465,388020,809943,0.6740806889755916
1461,Czechia,CZE,1995,1204735,362015,63200,390630,815845,0.6771987200504676
1462,Czechia,CZE,1996,1204821,363070,63516,390829,817415,0.6784534798115238
1463,Czechia,CZE,1990,1194774,355074,61399,383221,799694,0.6693265839397242
1464,Czechia,CZE,1998,1201922,365129,64172,387870,817171,0.6798868811786455
1465,Czechia,CZE,1999,1200574,366152,64512,386180,816844,0.6803778859112392
1466,Czechia,CZE,2000,1199887,367161,64820,385316,817297,0.6811449744850974
1467,Czechia,CZE,2001,1200127,368235,65105,385135,818475,0.6819903226908486
1468,Czechia,CZE,2002,1200480,369318,65386,385038,819742,0.6828451952552312
1469,Czechia,CZE,1997,1203730,364090,63837,389648,817575,0.679201315909714
1470,Democratic Republic of Congo,COD,2006,7226826,1962461,263288,2382480,4608229,0.6376560055548591
1471,Democratic Republic of Congo,COD,2007,7444948,2022393,271818,2453222,4747433,0.6376717473379263
1472,Democratic Republic of Congo,COD,2008,7667495,2084178,280631,2524593,4889402,0.6376791898788327
1473,Democratic Republic of Congo,COD,2009,7900915,2148424,289730,2601131,5039285,0.6378103042495711
1474,Democratic Republic of Congo,COD,2010,8142329,2216162,299188,2681880,5197230,0.6382977155553405
1475,Democratic Republic of Congo,COD,2011,8381777,2288520,308972,2769831,5367323,0.6403562156330335
1476,Democratic Republic of Congo,COD,2014,9068278,2530450,340553,3063757,5934760,0.654452807909065
1477,Democratic Republic of Congo,COD,2013,8837557,2446642,329628,2962488,5738758,0.6493602247770509
1478,Democratic Republic of Congo,COD,2015,9314851,2615827,351934,3169487,6137248,0.6588670071051056
1479,Democratic Republic of Congo,COD,2016,9569599,2704872,363700,3273698,6342270,0.6627519084132992
1480,Democratic Republic of Congo,COD,2017,9839024,2795391,375890,3381234,6552515,0.6659720516994369
1481,Democratic Republic of Congo,COD,2005,7011638,1903938,255054,2314484,4473476,0.6380072673460895
1482,Democratic Republic of Congo,COD,2019,10437269,2963026,401597,3633865,6998488,0.6705286603229255
1483,Democratic Republic of Congo,COD,2012,8613111,2365652,319111,2864453,5549216,0.6442754540142348
1484,Democratic Republic of Congo,COD,2018,10129437,2881325,388524,3502671,6772520,0.6685978697532745
1485,Democratic Republic of Congo,COD,2004,6799726,1847018,247110,2247849,4341977,0.6385517592914773
1486,Democratic Republic of Congo,COD,2002,6377900,1739795,232208,2125508,4097511,0.6424545696859468
1487,Democratic Republic of Congo,COD,1990,4286572,1229947,164261,1538044,2932252,0.6840552310797532
1488,Democratic Republic of Congo,COD,1991,4422649,1264358,168848,1578982,3012188,0.6810823106242435
1489,Democratic Republic of Congo,COD,1992,4565580,1300122,173590,1621275,3094987,0.6778956890471747
1490,Democratic Republic of Congo,COD,1993,4713951,1337314,178496,1664624,3180434,0.6746854178161801
1491,Democratic Republic of Congo,COD,1994,4870233,1376052,183585,1709308,3268945,0.6712091598081652
1492,Democratic Republic of Congo,COD,1995,5035526,1416546,188866,1756483,3361895,0.6676353175418019
1493,Democratic Republic of Congo,COD,2003,6588212,1792419,239504,2184558,4216481,0.6400038432278743
1494,Democratic Republic of Congo,COD,1997,5389185,1500349,199849,1852389,3552587,0.6592067260634029
1495,Democratic Republic of Congo,COD,1998,5577573,1544946,205763,1901990,3652699,0.6548903976693806
1496,Democratic Republic of Congo,COD,1999,5773783,1591207,211952,1954246,3757405,0.6507700410631989
1497,Democratic Republic of Congo,COD,2000,5971937,1639266,218429,2009892,3867587,0.6476268922461841
1498,Democratic Republic of Congo,COD,2001,6170802,1688800,225186,2066546,3980532,0.6450591025283261
1499,Democratic Republic of Congo,COD,1996,5206903,1457821,194264,1803868,3455953,0.6637252508832986
1500,Denmark,DNK,2007,737223,273394,56888,226189,556471,0.7548204545978625
1501,Denmark,DNK,2008,739851,274768,57233,225847,557848,0.7540004676617319
1502,Denmark,DNK,2009,743051,276264,57593,225972,559829,0.7534193480662835
1503,Denmark,DNK,2010,746576,277936,57984,226656,562576,0.7535415014680354
1504,Denmark,DNK,2011,750877,280045,58383,228063,566491,0.7544391424960413
1505,Denmark,DNK,2012,755198,282622,58770,229499,570891,0.7559487710507707
1506,Denmark,DNK,2015,770072,290677,60011,234440,585128,0.759835443958487
1507,Denmark,DNK,2014,765031,288215,59579,232811,580605,0.7589300302863544
1508,Denmark,DNK,2016,774315,292519,60447,235177,588143,0.7595655514874438
1509,Denmark,DNK,2017,778076,294029,60842,235941,590812,0.7593242819467507
1510,Denmark,DNK,2018,782866,295257,61181,237828,594266,0.7590903168613786
1511,Denmark,DNK,2006,735217,272172,56598,226833,555603,0.7556993377465429
1512,Denmark,DNK,2013,759925,285408,59169,231158,575735,0.7576208178438661
1513,Denmark,DNK,2005,733420,270955,56344,227683,554982,0.7567042076845464
1514,Denmark,DNK,2019,788590,296140,61492,240588,598220,0.7585944533914962
1515,Denmark,DNK,2003,731820,268812,56064,230619,555495,0.7590596048208575
1516,Denmark,DNK,1990,748182,262289,55052,263364,580705,0.7761547324046822
1517,Denmark,DNK,1991,747465,262769,55200,262706,580675,0.776859117149298
1518,Denmark,DNK,1992,746256,263074,55304,261432,579810,0.7769585772174696
1519,Denmark,DNK,1993,744978,263357,55399,259994,578750,0.7768685786694373
1520,Denmark,DNK,1994,743560,263653,55494,258207,577354,0.7764726451127011
1521,Denmark,DNK,1995,742409,263991,55588,256238,575817,0.7756061685674608
1522,Denmark,DNK,2004,732163,269792,56159,228831,554782,0.7577301775697488
1523,Denmark,DNK,1997,738742,264709,55745,249712,570166,0.7718066659266699
1524,Denmark,DNK,1998,736493,265127,55813,245529,566469,0.7691437664716433
1525,Denmark,DNK,1999,734161,265618,55870,241419,562907,0.766735089442234
1526,Denmark,DNK,2000,733001,266301,55940,238097,560338,0.7644437047152732
1527,Denmark,DNK,2001,732535,267096,55996,235501,558593,0.7625478646071518
1528,Denmark,DNK,2002,732124,267896,56020,232974,556890,0.760649835273806
1529,Denmark,DNK,1996,740985,264353,55683,253597,573633,0.7741492742768072
1530,Djibouti,DJI,2006,82824,23572,4300,27669,55541,0.6705906500531247
1531,Djibouti,DJI,2007,86028,24521,4483,28857,57861,0.6725833449574558
1532,Djibouti,DJI,2008,89463,25546,4683,30136,60365,0.6747482199344981
1533,Djibouti,DJI,2009,93087,26629,4893,31484,63006,0.6768506880660028
1534,Djibouti,DJI,2010,96802,27735,5103,32874,65712,0.6788289498150865
1535,Djibouti,DJI,2011,100398,28819,5302,34236,68357,0.6808601764975398
1536,Djibouti,DJI,2015,114721,33193,6073,39785,79051,0.6890717479798816
1537,Djibouti,DJI,2013,107473,30997,5687,36998,73682,0.6855861472183711
1538,Djibouti,DJI,2014,110983,32078,5876,38361,76315,0.6876278348936323
1539,Djibouti,DJI,2016,118547,34321,6275,41295,81891,0.6907893071946148
1540,Djibouti,DJI,2017,122365,35441,6476,42831,84748,0.6925836636293058
1541,Djibouti,DJI,2018,126181,36535,6677,44389,87601,0.6942487379240931
1542,Djibouti,DJI,2005,79959,22736,4140,26589,53465,0.6686551857827137
1543,Djibouti,DJI,2012,103972,29910,5497,35621,71028,0.6831454622398339
1544,Djibouti,DJI,2019,130042,37610,6879,45995,90484,0.6958059703788007
1545,Djibouti,DJI,2004,77473,22006,4002,25622,51630,0.6664257225097776
1546,Djibouti,DJI,2002,72138,20440,3704,23606,47750,0.6619257534170617
1547,Djibouti,DJI,2003,75011,21285,3865,24675,49825,0.6642359120662303
1548,Djibouti,DJI,1990,46554,13247,2346,14587,30180,0.6482794174507024
1549,Djibouti,DJI,1991,46013,13064,2305,14460,29829,0.6482733140634168
1550,Djibouti,DJI,1992,46494,13186,2324,14652,30162,0.6487288682410634
1551,Djibouti,DJI,1994,50570,14337,2536,15994,32867,0.6499307890053392
1552,Djibouti,DJI,1995,52180,14782,2619,16557,33958,0.6507857416634726
1553,Djibouti,DJI,1993,48597,13780,2434,15333,31547,0.6491552976521184
1554,Djibouti,DJI,1997,57380,16242,2897,18341,37480,0.6531892645521088
1555,Djibouti,DJI,1998,60324,17054,3053,19366,39473,0.6543498441747895
1556,Djibouti,DJI,1999,63163,17856,3208,20375,41439,0.6560644681221601
1557,Djibouti,DJI,2000,65969,18655,3363,21389,43407,0.6579908745016598
1558,Djibouti,DJI,2001,68950,19513,3528,22461,45502,0.6599274836838288
1559,Djibouti,DJI,1996,54423,15411,2739,17332,35482,0.651966999246642
1560,Dominica,DMA,2011,9600,3048,648,2155,5851,0.6094791666666667
1561,Dominica,DMA,2007,9553,2991,637,2126,5754,0.6023238773160263
1562,Dominica,DMA,2008,9557,3004,639,2126,5769,0.6036413100345297
1563,Dominica,DMA,2009,9564,3019,642,2129,5790,0.6053952321204517
1564,Dominica,DMA,2010,9576,3032,645,2138,5815,0.6072472848788638
1565,Dominica,DMA,2012,9628,3068,651,2178,5897,0.6124844204403822
1566,Dominica,DMA,2006,9552,2979,634,2125,5738,0.60071189279732
1567,Dominica,DMA,2014,9690,3109,657,2230,5996,0.618782249742002
1568,Dominica,DMA,2015,9704,3122,659,2249,6030,0.6213932399010718
1569,Dominica,DMA,2016,9703,3128,662,2262,6052,0.6237246212511595
1570,Dominica,DMA,2017,9700,3132,664,2275,6071,0.6258762886597938
1571,Dominica,DMA,2018,9714,3136,666,2308,6110,0.6289890879143504
1572,Dominica,DMA,2013,9661,3089,654,2205,5948,0.6156712555636062
1573,Dominica,DMA,2005,9551,2970,631,2119,5720,0.5988901685687362
1574,Dominica,DMA,2019,9748,3141,668,2363,6172,0.6331555190808371
1575,Dominica,DMA,2003,9540,2959,625,2097,5681,0.5954926624737945
1576,Dominica,DMA,1990,9905,2983,620,2081,5684,0.5738515901060071
1577,Dominica,DMA,1991,9835,2973,620,2064,5657,0.5751906456532792
1578,Dominica,DMA,1992,9769,2963,619,2049,5631,0.5764151909100215
1579,Dominica,DMA,1993,9710,2954,618,2037,5609,0.5776519052523172
1580,Dominica,DMA,1994,9656,2946,617,2028,5591,0.5790182270091135
1581,Dominica,DMA,1995,9619,2941,616,2026,5583,0.5804137644245764
1582,Dominica,DMA,2004,9543,2963,628,2108,5699,0.5971916588075029
1583,Dominica,DMA,1997,9569,2939,616,2035,5590,0.5841780750339638
1584,Dominica,DMA,1998,9555,2943,616,2044,5603,0.5863945578231292
1585,Dominica,DMA,1999,9548,2947,617,2054,5618,0.5883954754922497
1586,Dominica,DMA,2000,9543,2951,619,2063,5633,0.5902755946767264
1587,Dominica,DMA,2001,9539,2954,621,2073,5648,0.5920956075060279
1588,Dominica,DMA,2002,9539,2956,623,2085,5664,0.5937729321731837
1589,Dominica,DMA,1996,9589,2938,615,2029,5582,0.5821253519657942
1590,Dominican Republic,DOM,2007,1357857,411005,84426,343396,838827,0.6177579818787987
1591,Dominican Republic,DOM,2009,1394868,426423,87409,352963,866795,0.6214172237086233
1592,Dominican Republic,DOM,2010,1412959,433602,88910,358154,880666,0.6232778162706774
1593,Dominican Republic,DOM,2011,1430726,440526,90393,363304,894223,0.6250134547076099
1594,Dominican Republic,DOM,2012,1447993,447599,91869,367951,907419,0.6266736096099912
1595,Dominican Republic,DOM,2015,1497722,467762,96075,381693,945530,0.6313120859545363
1596,Dominican Republic,DOM,2014,1480788,461363,94710,376353,932426,0.6296823042866366
1597,Dominican Republic,DOM,2006,1338995,403455,82949,338529,824933,0.6160837045694719
1598,Dominican Republic,DOM,2016,1514797,473277,97391,387710,958378,0.6326775138846987
1599,Dominican Republic,DOM,2017,1531482,478832,98697,393884,971413,0.634296060939665
1600,Dominican Republic,DOM,2018,1551197,485459,99992,401510,986961,0.6362576771357861
1601,Dominican Republic,DOM,2019,1572360,492909,101269,410286,1004464,0.6388257142130301
1602,Dominican Republic,DOM,2013,1464372,454602,93311,372082,919995,0.6282522473797642
1603,Dominican Republic,DOM,2005,1319558,396443,81488,332691,810622,0.6143132776278117
1604,Dominican Republic,DOM,2008,1376391,418778,85915,348130,852823,0.6196080910148352
1605,Dominican Republic,DOM,2003,1277297,383274,78536,318835,780645,0.6111695243940916
1606,Dominican Republic,DOM,1990,985340,294062,59519,223493,577074,0.5856597722613515
1607,Dominican Republic,DOM,1991,1005873,300584,61014,229698,591296,0.5878435945690957
1608,Dominican Republic,DOM,1992,1026919,307176,62508,235989,605673,0.5897962740975676
1609,Dominican Republic,DOM,1993,1048322,313821,63990,242320,620131,0.5915462997056248
1610,Dominican Republic,DOM,1994,1069708,320518,65447,248639,634604,0.5932497466598361
1611,Dominican Republic,DOM,1995,1091592,327313,66891,255129,649333,0.594849540854092
1612,Dominican Republic,DOM,2004,1298846,389834,80015,325915,795764,0.6126700163067831
1613,Dominican Republic,DOM,1997,1137740,341390,69765,270563,681718,0.5991861057886687
1614,Dominican Republic,DOM,1998,1162243,348622,71214,279583,699419,0.6017837922018029
1615,Dominican Republic,DOM,1999,1186312,355850,72659,288423,716932,0.6043368017857023
1616,Dominican Republic,DOM,2000,1209801,362973,74111,296388,733472,0.6062749162878853
1617,Dominican Republic,DOM,2001,1232516,369867,75564,303808,749239,0.6078939340341221
1618,Dominican Republic,DOM,2002,1255251,376631,77046,311453,765130,0.6095434299594265
1619,Dominican Republic,DOM,1996,1114152,334255,68321,262253,664829,0.5967130158183085
1620,East Asia & Pacific (WB),,2006,245096788,75031606,6386510,64753997,146172113,0.5963852655629253
1621,East Asia & Pacific (WB),,2007,246347520,75677122,6465605,65274423,147417150,0.5984113418312472
1622,East Asia & Pacific (WB),,2008,247323484,76300407,6535975,65697223,148533605,0.6005640976657114
1623,East Asia & Pacific (WB),,2009,248125264,76833525,6598027,66185507,149617059,0.6029900244257271
1624,East Asia & Pacific (WB),,2010,249155903,77280505,6662951,66947150,150890606,0.6056071888451304
1625,East Asia & Pacific (WB),,2011,250264956,77502183,6729168,67978371,152209722,0.6081943090745794
1626,East Asia & Pacific (WB),,2015,254784087,77882289,6966631,72533573,157382493,0.6177092724005169
1627,East Asia & Pacific (WB),,2013,252192015,77424636,6852632,70273046,154550314,0.6128279438189191
1628,East Asia & Pacific (WB),,2014,253306534,77487786,6910435,71434125,155832346,0.6151927608784067
1629,East Asia & Pacific (WB),,2016,257220017,79351685,7019836,73467896,159839417,0.6214112683150939
1630,East Asia & Pacific (WB),,2017,259728138,80915018,7068818,74348284,162332120,0.6250078303029301
1631,East Asia & Pacific (WB),,2018,261264317,81499184,7115627,75200305,163815116,0.6270091449189367
1632,East Asia & Pacific (WB),,2005,243770833,74505478,6305222,64024805,144835505,0.5941461626789453
1633,East Asia & Pacific (WB),,2012,251220953,77492110,6792258,69103174,153387542,0.610568267369004
1634,East Asia & Pacific (WB),,2019,262195767,81636801,7159698,75923423,164719922,0.6282325755472628
1635,East Asia & Pacific (WB),,2004,242736421,74478264,6218341,63091887,143788492,0.5923647197550136
1636,East Asia & Pacific (WB),,2002,241283147,75545790,6027411,60947033,142520234,0.5906762895462401
1637,East Asia & Pacific (WB),,1990,208009268,64149186,5007942,50111073,119268201,0.5733792640431772
1638,East Asia & Pacific (WB),,1991,211946069,65011977,5096393,51659999,121768369,0.5745252534030248
1639,East Asia & Pacific (WB),,1992,215684330,65888314,5181651,53058047,124128012,0.5755077895552264
1640,East Asia & Pacific (WB),,1993,219216672,66786387,5264505,54306199,126357091,0.5764027427621928
1641,East Asia & Pacific (WB),,1994,222502476,67718523,5346550,55414352,128479425,0.5774291922935725
1642,East Asia & Pacific (WB),,1995,225522160,68688602,5427658,56374540,130490800,0.5786163098118606
1643,East Asia & Pacific (WB),,2003,242025464,74962335,6124018,62035202,143121555,0.5913491606817042
1644,East Asia & Pacific (WB),,1997,231073223,71357326,5591832,57530500,134479658,0.5819785445239581
1645,East Asia & Pacific (WB),,1998,233694531,72929819,5675130,57878438,136483387,0.58402473697598
1646,East Asia & Pacific (WB),,1999,236174155,74381322,5758489,58300780,138440591,0.5861801051008312
1647,East Asia & Pacific (WB),,2000,238432494,75462291,5842544,58962600,140267435,0.588289929140279
1648,East Asia & Pacific (WB),,2001,240182819,75833557,5932114,59899611,141665282,0.5898227133390419
1649,East Asia & Pacific (WB),,1996,228343131,69883218,5509571,57086635,132479424,0.5801769618373149
1650,Eastern Mediterranean Region (WHO),,2006,75663962,23952755,3241990,19622197,46816942,0.6187482225686252
1651,Eastern Mediterranean Region (WHO),,2007,77679529,24766730,3344552,20234921,48346203,0.6223802283868122
1652,Eastern Mediterranean Region (WHO),,2008,79820288,25653637,3452439,20877604,49983680,0.6262027017492094
1653,Eastern Mediterranean Region (WHO),,2009,81888863,26495326,3555429,21504359,51555114,0.6295741827554743
1654,Eastern Mediterranean Region (WHO),,2010,83799718,27206497,3648666,22100515,52955678,0.6319314582896329
1655,Eastern Mediterranean Region (WHO),,2011,85739075,27868969,3740882,22745117,54354968,0.6339579474119589
1656,Eastern Mediterranean Region (WHO),,2014,91711439,29882773,4001386,24892497,58776656,0.6408868581813442
1657,Eastern Mediterranean Region (WHO),,2013,89769417,29232816,3918069,24188632,57339517,0.6387422233119772
1658,Eastern Mediterranean Region (WHO),,2015,93648926,30517248,4087827,25553901,60158976,0.642388317405797
1659,Eastern Mediterranean Region (WHO),,2016,95512933,31004208,4180250,26175176,61359634,0.6424222570989417
1660,Eastern Mediterranean Region (WHO),,2017,97426948,31489156,4274506,26808173,62571835,0.6422436121061701
1661,Eastern Mediterranean Region (WHO),,2005,73851550,23281217,3147315,19050550,45479082,0.6158175691640866
1662,Eastern Mediterranean Region (WHO),,2019,101891584,32988438,4466977,28334961,65790376,0.6456899914324622
1663,Eastern Mediterranean Region (WHO),,2012,87762292,28553837,3831357,23460312,55845506,0.6363268862668263
1664,Eastern Mediterranean Region (WHO),,2018,99571347,32185949,4369567,27525434,64080950,0.6435681742861227
1665,Eastern Mediterranean Region (WHO),,2004,72112120,22685814,3056343,18494603,44236760,0.6134441755421973
1666,Eastern Mediterranean Region (WHO),,2002,68647795,21479793,2876843,17413251,41769887,0.6084665501637744
1667,Eastern Mediterranean Region (WHO),,2003,70377600,22082277,2966026,17950150,42998453,0.6109678789842222
1668,Eastern Mediterranean Region (WHO),,1990,50344880,15637468,2001620,12503475,30142563,0.5987215184543095
1669,Eastern Mediterranean Region (WHO),,1991,51785513,16118280,2067184,12844702,31030166,0.5992055345671674
1670,Eastern Mediterranean Region (WHO),,1992,53320440,16614711,2136842,13216963,31968516,0.5995546173287393
1671,Eastern Mediterranean Region (WHO),,1994,56319094,17608894,2274010,13967857,33850761,0.6010530105473643
1672,Eastern Mediterranean Region (WHO),,1995,57790568,18098015,2341928,14356711,34796654,0.60211649070485
1673,Eastern Mediterranean Region (WHO),,1993,54849410,17118136,2206603,13595716,32920455,0.6001970668417399
1674,Eastern Mediterranean Region (WHO),,1997,60843683,19018054,2486378,15165609,36670041,0.6026926575105587
1675,Eastern Mediterranean Region (WHO),,1998,62352799,19445041,2560062,15565557,37570660,0.6025496946817095
1676,Eastern Mediterranean Region (WHO),,1999,63838255,19879770,2634172,15973987,38487929,0.6028975729364783
1677,Eastern Mediterranean Region (WHO),,2000,65347797,20361910,2710400,16411419,39483729,0.6042090294183904
1678,Eastern Mediterranean Region (WHO),,2001,66947067,20899502,2790666,16894685,40584853,0.6062230179553646
1679,Eastern Mediterranean Region (WHO),,1996,59303160,18572273,2412849,14760917,35746039,0.6027678626231722
1680,Ecuador,ECU,2012,2122089,786395,138311,488409,1413115,0.6659075090630034
1681,Ecuador,ECU,2007,1912926,698329,123907,435282,1257518,0.6573793236121
1682,Ecuador,ECU,2008,1953658,714970,126715,445243,1286928,0.6587273719351084
1683,Ecuador,ECU,2009,1994374,731948,129563,455476,1316987,0.6603510675530266
1684,Ecuador,ECU,2010,2035535,749112,132466,466050,1347628,0.6620510087028717
1685,Ecuador,ECU,2013,2166222,806154,141300,500017,1447471,0.668200673799823
1686,Ecuador,ECU,2006,1872847,682205,121147,425521,1228873,0.6561523712294705
1687,Ecuador,ECU,2015,2251547,843371,147286,522770,1513427,0.6721720665835534
1688,Ecuador,ECU,2016,2300381,862285,150854,535962,1549101,0.6734106219795765
1689,Ecuador,ECU,2017,2356699,883922,154984,550901,1589807,0.6745906032123746
1690,Ecuador,ECU,2018,2406415,904613,158547,564441,1627601,0.676359231470881
1691,Ecuador,ECU,2019,2449132,924013,161526,576078,1661617,0.6784513860420753
1692,Ecuador,ECU,2014,2209031,825359,144278,511368,1481005,0.6704319676817573
1693,Ecuador,ECU,2005,1833177,666775,118453,415506,1200734,0.6550016719607544
1694,Ecuador,ECU,2011,2078603,767074,135356,476964,1379394,0.663615899717262
1695,Ecuador,ECU,2003,1754560,637371,113064,395093,1145528,0.652886193689586
1696,Ecuador,ECU,1991,1334008,475935,83344,282581,841860,0.6310756757080918
1697,Ecuador,ECU,1992,1365143,487253,85629,290460,863342,0.6324187282943985
1698,Ecuador,ECU,1993,1396725,498956,87950,298763,885669,0.6341040648660259
1699,Ecuador,ECU,1994,1429176,511139,90316,307293,908748,0.635854506372903
1700,Ecuador,ECU,1995,1462202,523924,92745,316001,932670,0.637853046295929
1701,Ecuador,ECU,1996,1496544,537296,95170,325097,957563,0.6398495466889046
1702,Ecuador,ECU,1990,1303450,464904,81100,274599,820603,0.6295623153937627
1703,Ecuador,ECU,2004,1793881,651825,115734,405389,1172948,0.6538605403591431
1704,Ecuador,ECU,1998,1567832,565851,100148,344456,1010455,0.6444918843345461
1705,Ecuador,ECU,1999,1604085,580421,102671,354572,1037664,0.646888413020507
1706,Ecuador,ECU,2000,1641260,594872,105245,364408,1064525,0.6486022933599795
1707,Ecuador,ECU,2001,1678080,609034,107809,374527,1091370,0.6503682780320366
1708,Ecuador,ECU,2002,1716163,623197,110428,384903,1118528,0.6517609341303827
1709,Ecuador,ECU,1997,1531783,551369,97647,334670,983686,0.6421836513396479
1710,Egypt,EGY,2007,10594338,3249268,553372,2681995,6484635,0.6120849646292199
1711,Egypt,EGY,2008,10893161,3447349,565962,2742221,6755532,0.620162687396248
1712,Egypt,EGY,2009,11183864,3633464,578240,2801380,7013084,0.6270716453633557
1713,Egypt,EGY,2010,11433490,3765320,590188,2862702,7218210,0.6313216699363011
1714,Egypt,EGY,2011,11663676,3855300,601913,2937865,7395078,0.6340263566992087
1715,Egypt,EGY,2012,11920708,3944901,613473,3035427,7593801,0.6370260055023578
1716,Egypt,EGY,2015,12689374,4206297,648097,3328264,8182658,0.6448433153597648
1717,Egypt,EGY,2014,12444801,4121331,636501,3244169,8002001,0.6429995144156986
1718,Egypt,EGY,2016,12902462,4280825,659891,3394570,8335286,0.64602290632594
1719,Egypt,EGY,2017,13124899,4356097,672072,3462867,8491036,0.6469410545559245
1720,Egypt,EGY,2018,13377276,4452315,684695,3544173,8681183,0.6489499805491044
1721,Egypt,EGY,2006,10317120,3078163,540548,2623140,6241851,0.6049993602865916
1722,Egypt,EGY,2013,12185337,4033745,624954,3141677,7800376,0.6401444621515187
1723,Egypt,EGY,2005,10087479,2968876,527571,2561056,6057503,0.600497210452681
1724,Egypt,EGY,2019,13660431,4565813,697799,3638842,8902454,0.6516964215843556
1725,Egypt,EGY,2003,9689145,2834225,501521,2432203,5767949,0.5953001012989279
1726,Egypt,EGY,1990,7668164,2333611,354591,1760619,4448821,0.5801676907275327
1727,Egypt,EGY,1991,7851361,2395593,364257,1817477,4577327,0.582997903166088
1728,Egypt,EGY,1992,8032208,2457137,374171,1873627,4704935,0.5857586108327872
1729,Egypt,EGY,1993,8209755,2518051,384327,1930212,4832590,0.5886399776850831
1730,Egypt,EGY,1994,8384582,2578608,394699,1984839,4958146,0.5913408682746498
1731,Egypt,EGY,1995,8559223,2639544,405331,2038564,5083439,0.5939136064103014
1732,Egypt,EGY,2004,9886471,2901326,514539,2495914,5911779,0.5979665544965438
1733,Egypt,EGY,1997,8791898,2658170,427430,2122040,5207640,0.5923226133879169
1734,Egypt,EGY,1998,8867842,2628167,438905,2155635,5222707,0.5889490363044357
1735,Egypt,EGY,1999,8959719,2610664,450758,2193832,5255254,0.586542278837093
1736,Egypt,EGY,2000,9103211,2638822,463033,2243577,5345432,0.5872029111486046
1737,Egypt,EGY,2001,9295806,2702620,475677,2305145,5483442,0.589883437756769
1738,Egypt,EGY,2002,9491026,2767882,488556,2367824,5624262,0.5925873556768256
1739,Egypt,EGY,1996,8698211,2670792,416244,2084811,5171847,0.5945874387273429
1740,El Salvador,SLV,2006,731835,245828,45824,186737,478389,0.6536842321014983
1741,El Salvador,SLV,2007,737712,249100,46365,188478,483943,0.6560053245711064
1742,El Salvador,SLV,2008,743597,252514,46943,190322,489779,0.6586618827133515
1743,El Salvador,SLV,2009,749403,255827,47541,192337,495705,0.6614665273557752
1744,El Salvador,SLV,2010,755027,258849,48153,194570,501572,0.6643100180523346
1745,El Salvador,SLV,2011,760269,261730,48768,196750,507248,0.667195426881801
1746,El Salvador,SLV,2015,777878,272113,50968,205455,528536,0.6794587326033131
1747,El Salvador,SLV,2013,769543,267364,49928,201013,518305,0.6735231169668232
1748,El Salvador,SLV,2014,773810,269898,50467,203187,523552,0.6765898605600859
1749,El Salvador,SLV,2016,782200,274046,51446,208121,533613,0.6821950907696241
1750,El Salvador,SLV,2017,786777,275883,51904,210794,538581,0.684540854651318
1751,El Salvador,SLV,2018,790987,277697,52333,212815,542845,0.6862881438000877
1752,El Salvador,SLV,2005,725916,242826,45311,185301,473438,0.6521939177535693
1753,El Salvador,SLV,2012,765191,264601,49359,198982,512942,0.6703450511048875
1754,El Salvador,SLV,2019,794550,279454,52738,214219,546411,0.6876986973758731
1755,El Salvador,SLV,2004,719936,239942,44820,183843,468605,0.6508981353898124
1756,El Salvador,SLV,2002,707522,234018,43900,181777,459695,0.649725379564169
1757,El Salvador,SLV,2003,713809,236980,44352,182786,464118,0.6501991429079768
1758,El Salvador,SLV,1990,634735,202829,37841,161345,402015,0.6333588032801091
1759,El Salvador,SLV,1991,642670,205837,38485,164215,408537,0.6356870555650646
1760,El Salvador,SLV,1992,650075,208698,39106,166891,414695,0.6379187016882667
1761,El Salvador,SLV,1994,663366,214018,40266,171706,425990,0.6421643557251955
1762,El Salvador,SLV,1995,669577,216536,40799,173876,431211,0.6440050957544838
1763,El Salvador,SLV,1993,656910,211423,39703,169399,420525,0.6401561857788738
1764,El Salvador,SLV,1997,680318,221356,41771,176966,440093,0.6468930705934578
1765,El Salvador,SLV,1998,685020,223673,42205,177926,443804,0.647870135178535
1766,El Salvador,SLV,1999,689976,226041,42625,178757,447423,0.6484616856238478
1767,El Salvador,SLV,2000,695459,228545,43050,179775,451370,0.6490246010188955
1768,El Salvador,SLV,2001,701318,231190,43470,180822,455482,0.6494657202581425
1769,El Salvador,SLV,1996,675327,218986,41303,175669,435958,0.6455509701226221
1770,England,,2011,7720116,2508485,669000,2452349,5629834,0.7292421512837372
1771,England,,2007,7399977,2349045,647063,2380032,5376140,0.7265076634697648
1772,England,,2008,7480845,2404979,652710,2385749,5443438,0.7276501518210844
1773,England,,2009,7562609,2455689,658248,2396137,5510074,0.7285943250536951
1774,England,,2010,7636493,2488782,663632,2414140,5566554,0.7289411513897807
1775,England,,2012,7825568,2527193,674076,2511128,5712397,0.7299657992876684
1776,England,,2006,7329215,2299936,641371,2376863,5318170,0.7256124973820525
1777,England,,2014,8035154,2562053,683348,2631716,5877117,0.7314255582407008
1778,England,,2015,8105694,2578110,687447,2664620,5930177,0.731606325133912
1779,England,,2016,8117288,2588033,691358,2656025,5935416,0.7312067774360107
1780,England,,2017,8125746,2597579,694924,2645527,5938030,0.7307673658517015
1781,England,,2018,8168072,2615100,698309,2660095,5973504,0.7313236220248793
1782,England,,2013,7936127,2545024,678856,2575695,5799575,0.7307815260516874
1783,England,,2005,7277183,2269298,635771,2373469,5278538,0.7253545774511924
1784,England,,2019,8210557,2637474,701624,2679133,6018231,0.7329869337731898
1785,England,,2003,7235407,2244795,623646,2397556,5265997,0.7278093685676562
1786,England,,1990,6948868,2024754,588815,2480725,5094294,0.7331113499349822
1787,England,,1991,6947767,2066146,589126,2436941,5092213,0.7329280040623124
1788,England,,1992,6951195,2104628,589597,2398660,5092885,0.732663232724733
1789,England,,1993,6960445,2138093,590410,2369441,5097944,0.7324163900440274
1790,England,,1994,6977653,2164159,591801,2353019,5108979,0.7321916122799457
1791,England,,1995,7003050,2179817,593687,2352805,5126309,0.7320109095322752
1792,England,,2004,7248742,2254767,629918,2379174,5263859,0.7261755212145776
1793,England,,1997,7069654,2196076,598102,2379428,5173606,0.7318046965240449
1794,England,,1998,7106967,2203548,600750,2396840,5201138,0.7318365204172188
1795,England,,1999,7144782,2211306,603826,2414229,5229361,0.7319133040028373
1796,England,,2000,7182818,2220380,607383,2429707,5257470,0.7319508861285362
1797,England,,2001,7212111,2229490,611885,2432463,5273838,0.7312474808000043
1798,England,,2002,7226716,2237085,617454,2418699,5273238,0.729686623910501
1799,England,,1996,7034867,2188425,595799,2364138,5148362,0.7318350155020699
1800,Equatorial Guinea,GNQ,2007,95926,29337,3836,36153,69326,0.7227029168317245
1801,Equatorial Guinea,GNQ,2009,105415,32196,4241,39796,76233,0.7231703268035858
1802,Equatorial Guinea,GNQ,2010,110503,33734,4458,41744,79936,0.7233830755726088
1803,Equatorial Guinea,GNQ,2011,115795,35357,4684,43799,83840,0.7240381709054795
1804,Equatorial Guinea,GNQ,2012,121372,37064,4919,46014,87997,0.7250189500049434
1805,Equatorial Guinea,GNQ,2015,138993,42510,5686,53184,101380,0.7293892498183362
1806,Equatorial Guinea,GNQ,2014,133040,40670,5421,50746,96837,0.7278788334335539
1807,Equatorial Guinea,GNQ,2006,91524,27987,3647,34475,66109,0.722313273021284
1808,Equatorial Guinea,GNQ,2016,144919,44418,5956,55534,105908,0.7308082446056072
1809,Equatorial Guinea,GNQ,2017,150915,46344,6234,57958,110536,0.7324387900473777
1810,Equatorial Guinea,GNQ,2018,157108,48155,6518,60729,115402,0.7345392978078774
1811,Equatorial Guinea,GNQ,2019,163535,49872,6808,63825,120505,0.7368758981257835
1812,Equatorial Guinea,GNQ,2013,127142,38842,5165,48358,92365,0.7264711896934136
1813,Equatorial Guinea,GNQ,2005,87306,26679,3469,32889,63037,0.7220236868027398
1814,Equatorial Guinea,GNQ,2008,100573,30735,4033,37918,72686,0.7227188211547831
1815,Equatorial Guinea,GNQ,2003,79685,24192,3139,30070,57401,0.720348873690155
1816,Equatorial Guinea,GNQ,1990,48665,13541,1795,18507,33843,0.6954279256138909
1817,Equatorial Guinea,GNQ,1991,50497,14071,1858,19073,35002,0.693150088124047
1818,Equatorial Guinea,GNQ,1992,52467,14644,1926,19691,36261,0.6911201326548116
1819,Equatorial Guinea,GNQ,1993,54562,15259,1999,20350,37608,0.6892709211539166
1820,Equatorial Guinea,GNQ,1994,56785,15918,2079,21048,39045,0.6875935546359073
1821,Equatorial Guinea,GNQ,1995,59158,16622,2164,21811,40597,0.686246999560499
1822,Equatorial Guinea,GNQ,2004,83333,25409,3300,31427,60136,0.7216348865395461
1823,Equatorial Guinea,GNQ,1997,63467,18167,2358,23479,44004,0.6933366946602171
1824,Equatorial Guinea,GNQ,1998,65478,19020,2467,24401,45888,0.7008155410977733
1825,Equatorial Guinea,GNQ,1999,67637,19930,2584,25394,47908,0.7083105400890045
1826,Equatorial Guinea,GNQ,2000,70207,20900,2709,26478,50087,0.713418889854288
1827,Equatorial Guinea,GNQ,2001,73197,21932,2844,27624,52400,0.7158763337295244
1828,Equatorial Guinea,GNQ,2002,76307,23031,2987,28812,54830,0.7185448255074894
1829,Equatorial Guinea,GNQ,1996,61411,17370,2257,22621,42248,0.6879549266418068
1830,Eritrea,ERI,2006,539068,159008,23965,170727,353700,0.6561324359821025
1831,Eritrea,ERI,2007,557112,164097,24786,176267,365150,0.655433736842861
1832,Eritrea,ERI,2008,575009,169064,25604,181706,376374,0.65455323307983
1833,Eritrea,ERI,2009,592025,173872,26396,186952,387220,0.6540602170516447
1834,Eritrea,ERI,2010,608094,178609,27158,192289,398056,0.6545961644087921
1835,Eritrea,ERI,2011,623491,183551,27907,197777,409235,0.6563607173158875
1836,Eritrea,ERI,2015,678514,203366,30717,219125,453208,0.6679420026705418
1837,Eritrea,ERI,2013,651125,193466,29298,208372,431136,0.662140142061816
1838,Eritrea,ERI,2014,664269,198341,29978,213532,441851,0.6651687795155276
1839,Eritrea,ERI,2016,694387,208930,31528,225327,465785,0.6707858874086065
1840,Eritrea,ERI,2017,712389,215131,32448,232167,479746,0.6734326330137046
1841,Eritrea,ERI,2018,732098,221609,33457,239843,494909,0.676014686558357
1842,Eritrea,ERI,2005,522909,154275,23228,165655,343158,0.656248027859532
1843,Eritrea,ERI,2012,638196,188642,28633,203230,420505,0.6588963265203793
1844,Eritrea,ERI,2019,752641,228250,34508,248051,510809,0.6786887772523686
1845,Eritrea,ERI,2004,507725,149708,22540,160779,333027,0.6559200354522625
1846,Eritrea,ERI,2002,472846,139100,20932,149497,309529,0.6546084771786163
1847,Eritrea,ERI,1990,327737,91274,13610,100276,205160,0.6259897417746547
1848,Eritrea,ERI,1991,321709,90075,13444,98796,202315,0.6288757852593493
1849,Eritrea,ERI,1992,335961,94538,14129,103493,212160,0.6315018707528552
1850,Eritrea,ERI,1993,352408,99659,14914,108921,223494,0.6341910512814692
1851,Eritrea,ERI,1994,367959,104618,15677,114125,234420,0.6370818487929362
1852,Eritrea,ERI,1995,380562,108715,16312,118414,243441,0.6396881454270263
1853,Eritrea,ERI,2003,492614,145114,21844,155823,322781,0.655241223351346
1854,Eritrea,ERI,1997,398969,115443,17347,125172,257962,0.6465715381395547
1855,Eritrea,ERI,1998,406798,118505,17814,128051,264370,0.6498802845638376
1856,Eritrea,ERI,1999,414455,121363,18243,130756,270362,0.6523313749381718
1857,Eritrea,ERI,2000,426935,125366,18848,134895,279109,0.6537505709300011
1858,Eritrea,ERI,2001,447858,131611,19798,141573,292982,0.654185031862778
1859,Eritrea,ERI,1996,389917,112046,16828,121862,250736,0.6430496746743538
1860,Estonia,EST,2007,176510,51184,8142,70078,129404,0.7331256019488981
1861,Estonia,EST,2008,174442,50926,8101,68816,127843,0.7328682312745783
1862,Estonia,EST,2009,172619,50693,8065,67707,126465,0.7326250296896634
1863,Estonia,EST,2010,171185,50466,8029,66865,125360,0.7323071530800012
1864,Estonia,EST,2011,169815,50226,7987,66079,124292,0.7319259193828578
1865,Estonia,EST,2012,168435,49970,7936,65226,123132,0.7310357111051741
1866,Estonia,EST,2015,165887,49446,7812,63530,120788,0.7281342118430015
1867,Estonia,EST,2014,166372,49563,7844,63848,121255,0.728818551198519
1868,Estonia,EST,2016,165567,49197,7789,63418,120404,0.727222212155804
1869,Estonia,EST,2017,165276,48929,7761,63380,120070,0.7264817638374598
1870,Estonia,EST,2018,165281,48860,7733,63467,120060,0.726399283644218
1871,Estonia,EST,2006,178764,51470,8187,71421,131078,0.7332460674408717
1872,Estonia,EST,2013,167254,49741,7886,64478,122105,0.7300572781517931
1873,Estonia,EST,2019,165474,48891,7708,63705,120304,0.7270266023665349
1874,Estonia,EST,2005,180979,51771,8221,72671,132663,0.7330297990374574
1875,Estonia,EST,2003,185869,52375,8264,75515,136154,0.7325266720109325
1876,Estonia,EST,2004,183365,52079,8245,74019,134343,0.7326534507675947
1877,Estonia,EST,1990,205532,56658,8887,82965,148510,0.7225638829963218
1878,Estonia,EST,1991,204742,56460,8855,82446,147761,0.7216936437076906
1879,Estonia,EST,1992,202881,55967,8771,81648,146386,0.7215362700302148
1880,Estonia,EST,1994,196604,54292,8483,79220,141995,0.7222386116253993
1881,Estonia,EST,1995,193647,53495,8346,78119,139960,0.7227584212510393
1882,Estonia,EST,1993,199964,55185,8637,80514,144336,0.7218099257866416
1883,Estonia,EST,1997,190552,52662,8204,77426,138292,0.7257441538267769
1884,Estonia,EST,1998,190219,52574,8193,77663,138430,0.7277401311120341
1885,Estonia,EST,1999,190325,52642,8217,78020,138879,0.7296939445685012
1886,Estonia,EST,2000,190550,52775,8260,78319,139354,0.7313251115192863
1887,Estonia,EST,2001,189855,52768,8281,77940,138989,0.732079745068605
1888,Estonia,EST,2002,188130,52617,8278,76901,137796,0.7324509647584118
1889,Estonia,EST,1996,191589,52945,8253,77510,138708,0.723987285282558
1890,Eswatini,SWZ,2011,110907,34796,5085,36951,76832,0.6927606012244493
1891,Eswatini,SWZ,2007,107368,33839,4875,34974,73688,0.686312495343119
1892,Eswatini,SWZ,2008,108169,34037,4925,35431,74393,0.687747876008838
1893,Eswatini,SWZ,2009,109001,34244,4977,35906,75127,0.6892322088788176
1894,Eswatini,SWZ,2010,109875,34487,5029,36400,75916,0.6909306029579068
1895,Eswatini,SWZ,2012,112084,35166,5144,37558,77868,0.6947289532850363
1896,Eswatini,SWZ,2006,106597,33640,4826,34526,72992,0.6847472255316753
1897,Eswatini,SWZ,2014,114747,36000,5268,38878,80146,0.6984583474949236
1898,Eswatini,SWZ,2015,116136,36437,5336,39544,81317,0.7001877109595647
1899,Eswatini,SWZ,2016,117579,36907,5407,40209,82523,0.7018515211049592
1900,Eswatini,SWZ,2017,119099,37369,5482,40918,83769,0.7033560315367887
1901,Eswatini,SWZ,2018,120475,37699,5560,41563,84822,0.7040630836273085
1902,Eswatini,SWZ,2019,121803,37888,5640,42221,85749,0.7039974384867368
1903,Eswatini,SWZ,2013,113405,35571,5204,38222,78997,0.6965918610290551
1904,Eswatini,SWZ,2005,105787,33424,4778,34085,72287,0.6833259285167365
1905,Eswatini,SWZ,2004,104947,33181,4729,33625,71535,0.6816297750293006
1906,Eswatini,SWZ,2003,103904,32897,4674,33069,70640,0.6798583307668618
1907,Eswatini,SWZ,1990,75372,23649,3286,22405,49340,0.6546197526933079
1908,Eswatini,SWZ,1991,77923,24487,3403,23258,51148,0.6563915660331353
1909,Eswatini,SWZ,1992,80566,25346,3523,24141,53010,0.6579698632177345
1910,Eswatini,SWZ,1993,83194,26217,3646,25044,54907,0.6599874990984926
1911,Eswatini,SWZ,1995,88467,27954,3898,26869,58721,0.6637616286298846
1912,Eswatini,SWZ,1996,91013,28794,4022,27761,60577,0.665586234933471
1913,Eswatini,SWZ,1994,85835,27092,3772,25951,56815,0.661909477485874
1914,Eswatini,SWZ,1998,95714,30356,4255,29507,64118,0.6698915519150803
1915,Eswatini,SWZ,1999,97792,31039,4360,30322,65721,0.6720488383507853
1916,Eswatini,SWZ,2000,99641,31633,4455,31064,67152,0.6739394425989301
1917,Eswatini,SWZ,2001,101237,32133,4539,31761,68433,0.6759682724695516
1918,Eswatini,SWZ,2002,102663,32552,4612,32458,69622,0.6781605836572085
1919,Eswatini,SWZ,1997,93418,29602,4142,28641,62385,0.6678049198227323
1920,Ethiopia,ETH,2011,9362959,2499309,422412,2716043,5637764,0.6021348592896754
1921,Ethiopia,ETH,2007,8645887,2227993,375285,2466493,5069771,0.5863795120153664
1922,Ethiopia,ETH,2008,8798714,2286040,385759,2514410,5186209,0.5894280686927658
1923,Ethiopia,ETH,2009,8965679,2349818,397174,2570892,5317884,0.5931378984235327
1924,Ethiopia,ETH,2010,9154009,2420513,409538,2637195,5467246,0.5972515430124659
1925,Ethiopia,ETH,2012,9585424,2587612,435935,2804623,5828170,0.6080242251151331
1926,Ethiopia,ETH,2019,11397496,3266058,543430,3564298,7373786,0.6469654387244356
1927,Ethiopia,ETH,2014,10066582,2781964,464863,3003467,6250294,0.620895354550333
1928,Ethiopia,ETH,2015,10313854,2879328,479824,3105969,6465121,0.6268385222439643
1929,Ethiopia,ETH,2016,10576560,2981683,495109,3213281,6690073,0.6325377060216176
1930,Ethiopia,ETH,2017,10845017,3083338,510787,3323442,6917567,0.6378567225851283
1931,Ethiopia,ETH,2018,11118175,3176718,526876,3438804,7142398,0.6424074094894171
1932,Ethiopia,ETH,2006,8490324,2173913,365616,2421947,4961476,0.5843682761694371
1933,Ethiopia,ETH,2013,9822674,2683523,450216,2901526,6035265,0.6144217959386619
1934,Ethiopia,ETH,2005,8323651,2122109,356542,2377808,4856459,0.5834529823511342
1935,Ethiopia,ETH,2004,8163219,2084286,347958,2336077,4768321,0.5841226359356524
1936,Ethiopia,ETH,2003,8022930,2064837,339905,2297327,4702069,0.5860787767062656
1937,Ethiopia,ETH,1991,5930085,1570883,245279,1789508,3605670,0.608030070395281
1938,Ethiopia,ETH,1992,6120195,1610638,252765,1835550,3698953,0.604384827607617
1939,Ethiopia,ETH,1993,6333531,1658062,261513,1889505,3809080,0.6014149137345345
1940,Ethiopia,ETH,1994,6549025,1708459,270548,1944396,3923403,0.5990820007558377
1941,Ethiopia,ETH,1995,6749557,1759252,279206,1996674,4035132,0.5978365691259441
1942,Ethiopia,ETH,1996,6937175,1809200,287459,2044518,4141177,0.5969543798448216
1943,Ethiopia,ETH,1990,5722477,1527111,237234,1739782,3504127,0.6123444445473525
1944,Ethiopia,ETH,1998,7282544,1905356,302865,2123364,4331585,0.5947900898367384
1945,Ethiopia,ETH,1999,7444686,1951501,310084,2156864,4418449,0.5935037421323075
1946,Ethiopia,ETH,2000,7602306,1996849,317209,2190040,4504098,0.5924647074190383
1947,Ethiopia,ETH,2001,7752275,2031386,324564,2225429,4581379,0.5909721984836709
1948,Ethiopia,ETH,2002,7889820,2050965,332152,2261205,4644322,0.5886473962650606
1949,Ethiopia,ETH,1997,7114005,1857865,295333,2086407,4239605,0.5959519286252961
1950,Europe & Central Asia (WB),,2008,120494196,41340171,7246654,36702675,85289500,0.7078307738573566
1951,Europe & Central Asia (WB),,2009,120926080,41727489,7276976,36876307,85880772,0.7101923092189873
1952,Europe & Central Asia (WB),,2010,121261624,41980802,7304568,37034923,86320293,0.7118516984400605
1953,Europe & Central Asia (WB),,2011,121558046,42157779,7330267,37174254,86662300,0.7129293605130836
1954,Europe & Central Asia (WB),,2012,121911859,42369223,7356216,37297607,87023046,0.7138193668263233
1955,Europe & Central Asia (WB),,2013,122308077,42594973,7382964,37410762,87388699,0.7144965495614816
1956,Europe & Central Asia (WB),,2016,123294836,43018657,7450126,37786035,88254818,0.7158030365521554
1957,Europe & Central Asia (WB),,2015,123065733,42962515,7430557,37672586,88065658,0.7155985330213732
1958,Europe & Central Asia (WB),,2017,123511760,43065122,7467950,37890510,88423582,0.7159122499752251
1959,Europe & Central Asia (WB),,2018,123712231,43093609,7482277,38044269,88620155,0.7163410948429182
1960,Europe & Central Asia (WB),,2019,123836243,43051654,7493359,38234993,88780006,0.7169145627261964
1961,Europe & Central Asia (WB),,2007,120016912,40901712,7212349,36526547,84640608,0.7052390083157614
1962,Europe & Central Asia (WB),,2014,122710714,42805093,7408289,37534067,87747449,0.7150756942054791
1963,Europe & Central Asia (WB),,2006,119573436,40498935,7175437,36370461,84044833,0.7028721078149832
1964,Europe & Central Asia (WB),,2005,119248393,40223087,7136519,36242767,83602373,0.7010775650452581
1965,Europe & Central Asia (WB),,1990,112983719,38052169,6521227,33953310,78526706,0.6950267409767242
1966,Europe & Central Asia (WB),,1991,113568208,38231575,6561452,34105860,78898887,0.6947268816639248
1967,Europe & Central Asia (WB),,1992,114111038,38397321,6599982,34252714,79250017,0.6944991333791916
1968,Europe & Central Asia (WB),,1993,114593462,38537802,6635111,34385458,79558371,0.6942662313492196
1969,Europe & Central Asia (WB),,1994,115017597,38651364,6667939,34517699,79837002,0.6941285862545016
1970,Europe & Central Asia (WB),,1995,115418705,38748357,6700482,34665286,80114125,0.6941173443247349
1971,Europe & Central Asia (WB),,1996,115885768,38844369,6734823,34859355,80438547,0.6941192899545697
1972,Europe & Central Asia (WB),,2004,119025795,40034962,7091912,36166908,83293782,0.699796056812727
1973,Europe & Central Asia (WB),,1998,116980367,39061020,6810122,35371922,81243064,0.6945017021531484
1974,Europe & Central Asia (WB),,1999,117500088,39184427,6850268,35629131,81663826,0.6950107645876827
1975,Europe & Central Asia (WB),,2000,117948180,39327175,6891993,35849837,82069005,0.6958056071742692
1976,Europe & Central Asia (WB),,2001,118295610,39486631,6937403,35998556,82422590,0.6967510459602009
1977,Europe & Central Asia (WB),,2002,118581151,39664022,6988189,36082056,82734267,0.6977016692981838
1978,Europe & Central Asia (WB),,2003,118809014,39848759,7041387,36125654,83015800,0.6987331786121884
1979,Europe & Central Asia (WB),,1997,116428146,38948394,6771473,35107805,80827672,0.6942279403813576
1980,European Region (WHO),,2007,121304176,41258604,7306980,36938001,85503585,0.7048692618793272
1981,European Region (WHO),,2008,121814137,41718195,7343013,37120585,86181793,0.7074859710248573
1982,European Region (WHO),,2009,122276680,42124595,7375039,37300491,86800125,0.7098665501876564
1983,European Region (WHO),,2010,122636649,42389698,7404328,37465222,87259248,0.7115266823704551
1984,European Region (WHO),,2011,122951329,42572691,7431779,37608693,87613163,0.7125841071632499
1985,European Region (WHO),,2012,123320369,42789789,7459534,37733233,87982556,0.7134470705322006
1986,European Region (WHO),,2016,124771887,43459549,7560551,38233592,89253692,0.7153349536181977
1987,European Region (WHO),,2014,124148934,43236212,7515219,37971109,88722540,0.7146460073511385
1988,European Region (WHO),,2015,124522161,43399046,7539244,38113905,89052195,0.7151513777535551
1989,European Region (WHO),,2017,125010106,43510458,7580103,38344843,89435404,0.7154253912879651
1990,European Region (WHO),,2018,125233474,43545065,7596180,38507055,89648300,0.7158493423251997
1991,European Region (WHO),,2019,125382053,43509932,7608986,38707426,89826344,0.7164210654614181
1992,European Region (WHO),,2006,120830390,40837715,7268335,36775383,84881433,0.7024841432689243
1993,European Region (WHO),,2013,123731160,43020914,7488111,37846853,88355878,0.7140956085758834
1994,European Region (WHO),,2004,120239608,40357975,7181373,36558811,84098159,0.6994214335761972
1995,European Region (WHO),,2000,119080825,39627924,6974218,36216188,82818330,0.6954799817686853
1996,European Region (WHO),,2003,120004472,40166522,7129119,36511826,83807467,0.6983695324287581
1997,European Region (WHO),,1990,113922641,38329309,6586374,34226799,79142482,0.6947037156556088
1998,European Region (WHO),,1991,114532076,38515249,6628331,34390864,79534444,0.6944294277875483
1999,European Region (WHO),,1992,115099598,38687269,6668568,34549162,79904999,0.6942248312630944
2000,European Region (WHO),,1993,115605500,38833634,6705357,34692660,80231651,0.6940124042541228
2001,European Region (WHO),,2005,120481222,40551353,7227686,36640953,84419992,0.7006900378218275
2002,European Region (WHO),,1995,116476022,39055694,6774129,34991883,80821706,0.6938913658984679
2003,European Region (WHO),,1994,116052441,38952910,6739864,34835077,80527851,0.6938919190850971
2004,European Region (WHO),,1997,117527362,39258624,6849038,35452793,81560455,0.6939699284665302
2005,European Region (WHO),,1998,118100903,39369714,6889903,35726725,81986342,0.6942058859617695
2006,European Region (WHO),,1999,118625387,39487088,6931309,35989945,82408342,0.6946939781111104
2007,European Region (WHO),,2001,119449905,39792839,7021460,36372220,83186519,0.6964134379177614
2008,European Region (WHO),,2002,119757206,39976339,7074148,36462301,83512788,0.6973508383286764
2009,European Region (WHO),,1996,116962549,39154415,6810236,35194413,81159064,0.6938893234961903
2010,Fiji,FJI,2011,97236,34780,2423,24980,62183,0.6395059443004648
2011,Fiji,FJI,2007,94932,33716,2347,24192,60255,0.6347174819871065
2012,Fiji,FJI,2008,95609,34020,2370,24408,60798,0.6359024778002071
2013,Fiji,FJI,2009,96178,34298,2390,24608,61296,0.6373183056416228
2014,Fiji,FJI,2010,96726,34542,2408,24792,61742,0.6383185493042202
2015,Fiji,FJI,2012,97724,35039,2436,25133,62608,0.640661454709181
2016,Fiji,FJI,2006,94211,33390,2321,23930,59641,0.6330577108830179
2017,Fiji,FJI,2014,98730,35551,2459,25447,63457,0.6427327053580472
2018,Fiji,FJI,2015,99222,35767,2470,25592,63829,0.6432948338070186
2019,Fiji,FJI,2016,99611,35899,2480,25739,64118,0.6436839304896046
2020,Fiji,FJI,2017,99984,36042,2491,25883,64416,0.6442630820931349
2021,Fiji,FJI,2018,100572,36306,2502,26099,64907,0.6453784353497991
2022,Fiji,FJI,2019,101244,36654,2515,26362,65531,0.6472581091225159
2023,Fiji,FJI,2013,98256,35302,2448,25299,63049,0.6416809151603974
2024,Fiji,FJI,2005,93407,33068,2292,23623,58983,0.6314623101052383
2025,Fiji,FJI,1990,80414,28034,1841,18623,48498,0.6031039371253761
2026,Fiji,FJI,2003,91760,32464,2228,22934,57626,0.6280078465562337
2027,Fiji,FJI,1991,81325,28398,1865,18897,49160,0.6044881647709807
2028,Fiji,FJI,1992,82196,28755,1890,19180,49825,0.6061730497834444
2029,Fiji,FJI,1993,83049,29101,1914,19464,50479,0.607821888282821
2030,Fiji,FJI,1994,83877,29439,1940,19750,51129,0.6095711577667299
2031,Fiji,FJI,1995,84693,29770,1967,20048,51785,0.6114436848381802
2032,Fiji,FJI,1996,85529,30104,1996,20365,52465,0.6134176711992424
2033,Fiji,FJI,2004,92588,32760,2261,23278,58299,0.6296604311573855
2034,Fiji,FJI,1998,87329,30813,2058,21079,53950,0.6177787447468768
2035,Fiji,FJI,1999,88273,31175,2092,21462,54729,0.6199970545920044
2036,Fiji,FJI,2000,89166,31525,2125,21831,55481,0.6222214745530807
2037,Fiji,FJI,2001,90041,31855,2159,22193,56207,0.6242378472029408
2038,Fiji,FJI,2002,90918,32168,2194,22568,56930,0.6261686354737236
2039,Fiji,FJI,1997,86421,30453,2026,20714,53193,0.615510119068282
2040,Finland,FIN,2008,766825,211824,54026,277136,542986,0.7080963714015583
2041,Finland,FIN,2009,776604,218806,54308,280548,553662,0.7129270516247663
2042,Finland,FIN,2010,782076,222551,54572,282176,559299,0.7151466097923987
2043,Finland,FIN,2011,782525,223909,54797,279887,558593,0.7138340628094949
2044,Finland,FIN,2012,780155,225223,55029,274071,554323,0.7105293178919574
2045,Finland,FIN,2013,776688,226425,55224,266932,548581,0.7063080670745524
2046,Finland,FIN,2016,772240,228189,55708,255964,539861,0.6990844815083394
2047,Finland,FIN,2015,773927,228318,55585,258659,542562,0.7010506158849608
2048,Finland,FIN,2017,770503,227938,55837,253519,537294,0.6973288877525461
2049,Finland,FIN,2018,774343,228469,55936,256472,540877,0.6984979524577609
2050,Finland,FIN,2019,780382,229295,56028,261800,547123,0.7010963861288446
2051,Finland,FIN,2007,755752,203905,53745,273176,530826,0.7023812044162635
2052,Finland,FIN,2014,774137,227488,55414,261018,543920,0.7026146534786478
2053,Finland,FIN,2006,746557,197154,53450,270052,520656,0.6974095748884546
2054,Finland,FIN,2005,741700,193748,53176,268665,515589,0.6951449373061885
2055,Finland,FIN,1990,768820,217690,50517,274711,542918,0.7061704950443537
2056,Finland,FIN,2004,742477,192711,52969,270976,516656,0.6958545517234878
2057,Finland,FIN,1991,758870,210668,50743,271521,532932,0.7022704811100715
2058,Finland,FIN,1992,750871,204237,50967,269436,524640,0.6987085664514944
2059,Finland,FIN,1993,744737,198857,51174,268204,518235,0.6958631033505788
2060,Finland,FIN,1995,739819,192924,51593,268480,512997,0.6934087932318581
2061,Finland,FIN,1996,741477,191913,51793,271010,514716,0.6941766231454246
2062,Finland,FIN,1994,741039,194913,51393,267971,514277,0.6939945131092965
2063,Finland,FIN,1998,750723,190021,52222,282915,525158,0.6995363136602981
2064,Finland,FIN,1999,755442,189551,52441,288406,530398,0.702102874873253
2065,Finland,FIN,2000,758272,189681,52634,291203,533518,0.7035971260972316
2066,Finland,FIN,2001,757024,190218,52765,289200,532183,0.7029935642727311
2067,Finland,FIN,2002,752569,190925,52812,283653,527390,0.7007862401985732
2068,Finland,FIN,2003,746937,191747,52866,276818,521431,0.6980923424599397
2069,Finland,FIN,1997,745511,190855,52002,276456,519313,0.6965866365486224
2070,France,FRA,2011,10253844,4192085,640433,3028282,7860800,0.7666198159441474
2071,France,FRA,2007,10148098,4303376,628537,2869404,7801317,0.7687467149016496
2072,France,FRA,2008,10172792,4240929,631846,2940643,7813418,0.7680701620558054
2073,France,FRA,2009,10196814,4188652,634869,3002859,7826380,0.7675318977084411
2074,France,FRA,2010,10229855,4174994,637701,3036532,7849227,0.7672862420826102
2075,France,FRA,2012,10252537,4212232,643194,2989580,7845006,0.7651770483734904
2076,France,FRA,2006,10117053,4348375,624839,2810741,7783955,0.7693895643326174
2077,France,FRA,2014,10245286,4257194,649042,2897133,7803369,0.7616545794817245
2078,France,FRA,2015,10271251,4278356,652028,2886474,7816858,0.7610424475071245
2079,France,FRA,2016,10315682,4295312,654944,2903648,7853904,0.7613557688187751
2080,France,FRA,2017,10359040,4311626,657796,2921822,7891244,0.761773677869764
2081,France,FRA,2018,10396567,4331537,660535,2936647,7928719,0.7626285676800814
2082,France,FRA,2019,10431111,4353885,663121,2950518,7967524,0.7638231440543581
2083,France,FRA,2013,10244898,4234392,646046,2938381,7818819,0.7631914929753327
2084,France,FRA,2005,10073922,4349817,620818,2780480,7751115,0.7694237656396387
2085,France,FRA,1990,9468326,3784454,570379,2864306,7219139,0.7624514618529189
2086,France,FRA,2003,9995855,4268074,611744,2818672,7698490,0.770168234733297
2087,France,FRA,2004,10029313,4313710,616392,2788218,7718320,0.7695761414565484
2088,France,FRA,1991,9426181,3773881,573171,2814977,7162029,0.7598017691364085
2089,France,FRA,1992,9391572,3766948,575684,2772165,7114797,0.7575725341827758
2090,France,FRA,1993,9369493,3763998,577958,2739584,7081540,0.7558082385034067
2091,France,FRA,1995,9382571,3775877,582858,2723687,7082422,0.7548487509447037
2092,France,FRA,1996,9443106,3815091,585583,2742927,7143601,0.7564884901217883
2093,France,FRA,1994,9364281,3766586,580288,2722104,7068978,0.7548874280897807
2094,France,FRA,1998,9669963,3986919,591496,2811927,7390342,0.7642575261146294
2095,France,FRA,1999,9786818,4074125,594809,2847205,7516139,0.767985978690929
2096,France,FRA,2000,9873959,4131347,598549,2875529,7605425,0.770250818339432
2097,France,FRA,2001,9929639,4171221,602664,2879368,7653253,0.7707483625537646
2098,France,FRA,2002,9968341,4218940,607139,2855659,7681738,0.7706134852328989
2099,France,FRA,1997,9547286,3892993,588467,2774527,7255987,0.760005199383364
2100,G20,,2011,591039474,182686343,22567140,161852628,367106111,0.6211194465836981
2101,G20,,2007,574741292,174037094,21561951,159921902,355520947,0.6185756129733585
2102,G20,,2008,578328319,176902187,21818542,159060623,357781352,0.6186474710742982
2103,G20,,2009,582031482,179588068,22070711,158613111,360271890,0.6189903830665985
2104,G20,,2010,586446519,181654770,22321054,159638413,363614237,0.6200296620739256
2105,G20,,2012,595070184,182911854,22808819,164161469,369882142,0.6215773398587888
2106,G20,,2019,628415495,193124907,24344859,179282499,396752265,0.6313534089416429
2107,G20,,2014,603096679,183144463,23283934,168920960,375349357,0.6223701274932738
2108,G20,,2015,607841024,184303583,23513351,171269103,379086037,0.6236598420181656
2109,G20,,2016,613803379,186979067,23733977,173471874,384184918,0.6259087700460508
2110,G20,,2017,619751761,189727665,23945791,175640891,389314347,0.6281778794332462
2111,G20,,2018,624487888,191578183,24149317,177630423,393357923,0.6298887945765891
2112,G20,,2006,570727685,171393142,21299351,160169810,352862303,0.6182673668616584
2113,G20,,2013,598971138,182876209,23048405,166529508,372454122,0.6218231536892517
2114,G20,,2005,565832601,169351694,21029107,158887779,349268580,0.6172648578090678
2115,G20,,2004,560460763,168069140,20741355,156379095,345189590,0.6159032224705443
2116,G20,,2003,555145021,167190004,20438307,153609004,341237315,0.614681393314703
2117,G20,,1990,462606378,138493746,17032589,119271546,274797881,0.5940209518685019
2118,G20,,1991,471135400,140261885,17277543,123201276,280740704,0.5958811500897618
2119,G20,,1992,479434161,142038287,17523397,126904861,286466545,0.5975096651487878
2120,G20,,1993,487397864,143812008,17768013,130306445,291886466,0.5988669371764009
2121,G20,,1995,501930006,147388907,18259905,135957885,301606697,0.6008939361955579
2122,G20,,1996,508889693,149785661,18511167,138115521,306412349,0.6021193850353734
2123,G20,,1994,494928361,145591108,18012668,133353467,296957243,0.6000004574399405
2124,G20,,1998,523551063,156710538,19024670,141653987,317389195,0.6062239529824047
2125,G20,,1999,530811385,160271254,19286450,143451735,323009439,0.6085201789709164
2126,G20,,2000,537678402,163179135,19552313,145545608,328277056,0.6105453646248562
2127,G20,,2001,543967742,165111376,19833564,148048686,332993626,0.6121569355853458
2128,G20,,2002,549728408,166332014,20132101,150783634,337247749,0.6134806644374835
2129,G20,,1997,516173000,153047709,18765943,139944320,311757972,0.6039796192361864
2130,Gabon,GAB,2011,180919,56760,7791,72599,137150,0.7580740552401903
2131,Gabon,GAB,2007,166655,51939,7062,67063,126064,0.756436950586541
2132,Gabon,GAB,2008,169941,53088,7239,68212,128539,0.756374271070548
2133,Gabon,GAB,2009,173336,54263,7419,69436,131118,0.756438362486731
2134,Gabon,GAB,2010,176980,55482,7605,70910,133997,0.7571307492372019
2135,Gabon,GAB,2012,184861,58102,7982,74302,140386,0.7594138298505364
2136,Gabon,GAB,2019,214849,67928,9394,87765,165087,0.7683861688907093
2137,Gabon,GAB,2014,193273,60913,8375,77933,147221,0.7617256419675795
2138,Gabon,GAB,2015,197529,62326,8578,79810,150714,0.7629968257825434
2139,Gabon,GAB,2016,202013,63952,8779,81810,154541,0.7650052224361799
2140,Gabon,GAB,2017,206543,65571,8982,83811,158364,0.7667362244181599
2141,Gabon,GAB,2018,210806,66856,9187,85827,161870,0.7678623948084969
2142,Gabon,GAB,2006,163319,50794,6889,65867,123550,0.7564949577207796
2143,Gabon,GAB,2013,189043,59494,8176,76084,143754,0.7604301666816544
2144,Gabon,GAB,2005,159806,49648,6720,64515,120883,0.7564359285633832
2145,Gabon,GAB,2004,156311,48497,6556,63138,118191,0.756127207938021
2146,Gabon,GAB,2003,152873,47359,6399,61805,115563,0.7559412060991804
2147,Gabon,GAB,1991,113663,35035,4725,45704,85464,0.7519069530102144
2148,Gabon,GAB,1992,116669,35991,4854,46908,87753,0.7521535283580043
2149,Gabon,GAB,1993,119760,36963,4985,48141,90089,0.752246158984636
2150,Gabon,GAB,1994,122870,37947,5117,49390,92454,0.7524538129730609
2151,Gabon,GAB,1995,126033,38940,5251,50670,94861,0.7526679520443058
2152,Gabon,GAB,1996,129282,39935,5387,52035,97357,0.7530592039108306
2153,Gabon,GAB,1990,110714,34100,4600,44547,83247,0.7519103275105226
2154,Gabon,GAB,1998,135972,41972,5666,54923,102561,0.7542802930015003
2155,Gabon,GAB,1999,139365,43015,5808,56395,105218,0.7549815233379974
2156,Gabon,GAB,2000,142755,44068,5952,57824,107844,0.7554481454239781
2157,Gabon,GAB,2001,146128,45135,6097,59202,110434,0.755734698346655
2158,Gabon,GAB,2002,149527,46235,6246,60517,112998,0.7557029834076788
2159,Gabon,GAB,1997,132570,40945,5525,53447,99917,0.7536923889266048
2160,Gambia,GMB,2008,180045,49292,7377,65738,122407,0.6798689216584742
2161,Gambia,GMB,2009,184848,50783,7595,67052,125430,0.6785575175279148
2162,Gambia,GMB,2010,190099,52362,7823,68693,128878,0.6779520144766674
2163,Gambia,GMB,2011,195934,54057,8061,70695,132813,0.677845601069748
2164,Gambia,GMB,2012,202109,55873,8311,72844,137028,0.6779905892365011
2165,Gambia,GMB,2013,208526,57775,8573,75094,141442,0.6782943134189502
2166,Gambia,GMB,2016,228544,63734,9422,82419,155575,0.6807223116774013
2167,Gambia,GMB,2015,221789,61693,9127,79879,150699,0.6794701270126111
2168,Gambia,GMB,2017,235280,65791,9727,84997,160515,0.6822296837810269
2169,Gambia,GMB,2018,242421,67843,10044,87874,165761,0.6837732704674925
2170,Gambia,GMB,2019,249781,69950,10372,91023,171345,0.6859809192852939
2171,Gambia,GMB,2007,175631,47880,7167,64609,119656,0.6812920270339519
2172,Gambia,GMB,2014,215068,59728,8845,77433,146006,0.6788829579481839
2173,Gambia,GMB,2006,171275,46536,6965,63412,116913,0.6826039994161436
2174,Gambia,GMB,2005,166851,45248,6770,61963,113981,0.6831304577137686
2175,Gambia,GMB,1990,102284,28147,4121,36376,68644,0.6711118063431231
2176,Gambia,GMB,1991,107116,29395,4306,38240,71941,0.6716176854998319
2177,Gambia,GMB,1992,111946,30643,4493,40148,75284,0.6725028138566809
2178,Gambia,GMB,1993,116719,31872,4680,42029,78581,0.6732494281136747
2179,Gambia,GMB,1994,121328,33059,4861,43873,81793,0.6741477647369115
2180,Gambia,GMB,1995,125681,34208,5038,45565,84811,0.6748116262601348
2181,Gambia,GMB,1996,129916,35317,5210,47214,87741,0.6753671603189754
2182,Gambia,GMB,2004,162477,44012,6582,60309,110903,0.682576610843381
2183,Gambia,GMB,1998,138025,37431,5548,50412,93391,0.6766238000362254
2184,Gambia,GMB,1999,142001,38468,5715,52012,96195,0.6774248068675572
2185,Gambia,GMB,2000,145982,39516,5883,53652,99051,0.678515159403214
2186,Gambia,GMB,2001,150008,40590,6052,55317,101959,0.6796904165111194
2187,Gambia,GMB,2002,154019,41690,6224,56962,104876,0.6809289762951324
2188,Gambia,GMB,2003,158188,42827,6400,58659,107886,0.682011277720181
2189,Gambia,GMB,1997,134000,36386,5380,48824,90590,0.676044776119403
2190,Georgia,GEO,2007,474238,114097,24271,161522,299890,0.632361809892923
2191,Georgia,GEO,2008,466036,112298,23965,160145,296408,0.6360195349715473
2192,Georgia,GEO,2009,458143,110537,23656,158731,292924,0.6393724230207599
2193,Georgia,GEO,2010,450962,108881,23360,157403,289644,0.6422802808218875
2194,Georgia,GEO,2011,444197,107320,23071,156368,286759,0.6455671695216312
2195,Georgia,GEO,2012,438235,105871,22802,155442,284115,0.6483165424943238
2196,Georgia,GEO,2016,419641,101320,21796,151714,274830,0.6549169409090151
2197,Georgia,GEO,2014,428254,103369,22291,153779,279439,0.6525076239801613
2198,Georgia,GEO,2015,423932,102280,22046,152882,277208,0.6538973231556005
2199,Georgia,GEO,2017,415516,100396,21552,150501,272449,0.6556883489444449
2200,Georgia,GEO,2018,411815,99381,21316,149707,270404,0.6566152277114724
2201,Georgia,GEO,2019,408722,98349,21094,149260,268703,0.6574224044705202
2202,Georgia,GEO,2006,482920,115924,24566,163056,303546,0.6285637372649714
2203,Georgia,GEO,2013,432961,104548,22540,154654,281742,0.6507329759493349
2204,Georgia,GEO,2004,501958,119938,25231,166499,311668,0.6209045378298583
2205,Georgia,GEO,2000,543295,128694,26881,174816,330391,0.6081244995812588
2206,Georgia,GEO,2003,512573,122169,25624,168570,316363,0.6172057443525117
2207,Georgia,GEO,1990,589243,144235,30545,194803,369583,0.6272166152164727
2208,Georgia,GEO,1991,588480,143487,30364,193641,367492,0.6244766177270256
2209,Georgia,GEO,1992,586312,142374,30098,191935,364407,0.6215240349847863
2210,Georgia,GEO,1993,582552,140955,29753,189910,360618,0.6190314341037366
2211,Georgia,GEO,2005,492029,117860,24882,164603,307345,0.6246481406583758
2212,Georgia,GEO,1995,573208,137721,28975,185538,352234,0.6144959595818621
2213,Georgia,GEO,1994,577905,139352,29368,187647,356367,0.616653256158019
2214,Georgia,GEO,1997,564136,134526,28176,181570,344272,0.6102641916133699
2215,Georgia,GEO,1998,558633,132723,27744,179429,339896,0.6084423942015599
2216,Georgia,GEO,1999,551629,130753,27307,176999,335059,0.6073991758953935
2217,Georgia,GEO,2001,533880,126592,26461,172800,325853,0.6103487675132989
2218,Georgia,GEO,2002,523564,124428,26045,170778,321251,0.6135849676448343
2219,Georgia,GEO,1996,568690,136153,28580,183622,348355,0.6125569290826285
2220,Germany,DEU,2011,12196674,5518582,713384,3385303,9617269,0.7885157051832328
2221,Germany,DEU,2007,12045733,5314749,718480,3339317,9372546,0.7780801716259194
2222,Germany,DEU,2008,12127986,5404347,717479,3363403,9485229,0.7820943229980641
2223,Germany,DEU,2009,12187695,5480786,715828,3379353,9575967,0.7857077979060028
2224,Germany,DEU,2010,12205059,5513842,714312,3382849,9611003,0.7874605931851701
2225,Germany,DEU,2012,12227256,5535704,713967,3401216,9650887,0.7892929533821815
2226,Germany,DEU,2006,11976817,5241260,718929,3320090,9280279,0.7748535357933581
2227,Germany,DEU,2014,12344411,5590587,717846,3451034,9759467,0.7905980285329126
2228,Germany,DEU,2015,12419384,5620052,720993,3479876,9820921,0.7907736003653644
2229,Germany,DEU,2016,12486844,5645053,724463,3498720,9868236,0.7902906450981529
2230,Germany,DEU,2017,12560603,5675448,728796,3512113,9916357,0.7894809667975335
2231,Germany,DEU,2018,12603399,5703031,731748,3510876,9945655,0.7891248225974596
2232,Germany,DEU,2019,12609726,5722474,732895,3492814,9948183,0.7889293550073967
2233,Germany,DEU,2013,12275653,5560620,715493,3422284,9698397,0.7900514131508931
2234,Germany,DEU,2005,11954140,5215081,718996,3308532,9242609,0.7731722231795847
2235,Germany,DEU,1990,11376608,5044020,686835,2990094,8720949,0.7665684710240521
2236,Germany,DEU,2003,11919661,5247066,716525,3224291,9187882,0.7708173915348767
2237,Germany,DEU,1991,11468353,5121422,689413,2993474,8804309,0.7677047436541237
2238,Germany,DEU,1992,11568621,5197333,692706,3001179,8891218,0.7685633404361678
2239,Germany,DEU,1993,11658299,5261489,695724,3008368,8965581,0.7690299416750248
2240,Germany,DEU,1994,11724369,5307069,698134,3014150,9019353,0.769282594227459
2241,Germany,DEU,1995,11771019,5333957,700397,3021037,9055391,0.7692954195384444
2242,Germany,DEU,1996,11790799,5340782,702361,3023478,9066621,0.7689573030631767
2243,Germany,DEU,2004,11949467,5227158,718193,3281645,9226996,0.7721679971165241
2244,Germany,DEU,1998,11796550,5321259,705561,3028990,9055810,0.7676659701353362
2245,Germany,DEU,1999,11794985,5305156,707089,3036578,9048823,0.7671754563486092
2246,Germany,DEU,2000,11803618,5294320,708869,3051629,9054818,0.7671222501439813
2247,Germany,DEU,2001,11832215,5282834,711256,3091306,9085396,0.7678525111316858
2248,Germany,DEU,2002,11877656,5266596,713923,3155310,9135829,0.769160935457299
2249,Germany,DEU,1997,11797861,5334331,704003,3026434,9064768,0.7683399558614905
2250,Ghana,GHA,2008,2417668,666393,112015,799236,1577644,0.6525478270796486
2251,Ghana,GHA,2009,2488106,687962,115725,822967,1626654,0.6537719855986843
2252,Ghana,GHA,2010,2560969,709841,119539,848421,1677801,0.6551430337501157
2253,Ghana,GHA,2011,2635319,732402,123444,876431,1732277,0.6573310479680069
2254,Ghana,GHA,2012,2711874,755983,127441,906923,1790347,0.6601881208345225
2255,Ghana,GHA,2013,2787637,780175,131526,938252,1849953,0.6636276530983051
2256,Ghana,GHA,2016,3023063,851395,144225,1034078,2029698,0.6714044662648446
2257,Ghana,GHA,2015,2945337,828402,139924,1003014,1971340,0.66930880914476
2258,Ghana,GHA,2017,3103375,874215,148591,1066706,2089512,0.673303097434245
2259,Ghana,GHA,2018,3184398,897418,153030,1101332,2151780,0.6757258357780654
2260,Ghana,GHA,2019,3265916,920632,157544,1137697,2215873,0.6784843823294904
2261,Ghana,GHA,2007,2348534,645365,108424,776192,1529981,0.6514621461728891
2262,Ghana,GHA,2014,2865554,804499,135690,970571,1910760,0.6668029986522676
2263,Ghana,GHA,2006,2280488,625045,104961,753848,1483854,0.6506738908514318
2264,Ghana,GHA,2005,2213888,605571,101629,730934,1438134,0.6495965468894542
2265,Ghana,GHA,1990,1466257,397425,64687,464270,926382,0.6318005642939812
2266,Ghana,GHA,2004,2148351,586904,98435,708036,1393375,0.6485788402360695
2267,Ghana,GHA,1991,1505209,408133,66638,478564,953335,0.6333572281324388
2268,Ghana,GHA,1992,1544866,419093,68641,493301,981035,0.6350291869974484
2269,Ghana,GHA,1993,1585925,430350,70702,508565,1009617,0.6366108107256018
2270,Ghana,GHA,1995,1671611,453862,74997,539992,1068851,0.6394137152722733
2271,Ghana,GHA,1996,1716731,466156,77243,556356,1099755,0.6406099732573128
2272,Ghana,GHA,1994,1628192,441920,72818,524324,1039062,0.6381692085454296
2273,Ghana,GHA,1998,1808985,491796,81934,588913,1162643,0.64270461059655
2274,Ghana,GHA,1999,1858027,505497,84404,605930,1195831,0.6436025956565755
2275,Ghana,GHA,2000,1910353,520018,86973,624376,1231367,0.644575636021196
2276,Ghana,GHA,2001,1965922,535486,89654,643816,1268956,0.6454762701673821
2277,Ghana,GHA,2002,2024174,551804,92452,664473,1308729,0.6465496543281358
2278,Ghana,GHA,2003,2085009,568957,95377,685714,1350048,0.6475022409975209
2279,Ghana,GHA,1997,1762257,478745,79552,572485,1130782,0.6416669078346688
2280,Greece,GRC,2011,1892040,660702,115036,732223,1507961,0.7970027060738674
2281,Greece,GRC,2007,1923982,661347,117223,749837,1528407,0.7943977646360517
2282,Greece,GRC,2008,1921254,662137,116880,750018,1529035,0.7958526046009533
2283,Greece,GRC,2009,1918193,662716,116449,749751,1528916,0.7970605668981171
2284,Greece,GRC,2010,1912430,662416,115877,747751,1526044,0.7979607096730338
2285,Greece,GRC,2012,1852721,657326,113869,699280,1470475,0.7936839923550281
2286,Greece,GRC,2006,1926548,660670,117485,749382,1527537,0.7928881086793581
2287,Greece,GRC,2014,1768330,650022,111355,627369,1388746,0.7853432334462459
2288,Greece,GRC,2015,1744422,646796,110239,610862,1367897,0.7841548661963677
2289,Greece,GRC,2016,1736839,643299,109369,611233,1363901,0.7852777373147425
2290,Greece,GRC,2017,1735557,639721,108760,617179,1365660,0.7868713041403999
2291,Greece,GRC,2018,1737318,635746,108167,627655,1371568,0.7894743506945764
2292,Greece,GRC,2019,1742480,630425,107551,643258,1381234,0.7926828428446812
2293,Greece,GRC,2013,1807389,653376,112564,660305,1426245,0.7891189998389943
2294,Greece,GRC,2005,1928478,660169,117651,749066,1526886,0.7917570228957759
2295,Greece,GRC,1990,1714052,610467,104795,592453,1307715,0.7629377638484713
2296,Greece,GRC,2003,1950060,662359,117651,766480,1546490,0.793047393413536
2297,Greece,GRC,2004,1935662,660623,117695,754047,1532365,0.7916490585649767
2298,Greece,GRC,1991,1727067,616964,106059,595214,1318237,0.7632807528601959
2299,Greece,GRC,1992,1745302,624920,107593,600835,1333348,0.7639640589422346
2300,Greece,GRC,1993,1761827,631686,108949,606695,1347330,0.7647345624740681
2301,Greece,GRC,1995,1791243,642641,111422,620096,1374159,0.7671538702454106
2302,Greece,GRC,1996,1817074,647329,112567,640867,1400763,0.7708893528827114
2303,Greece,GRC,1994,1777112,637503,110209,613397,1361109,0.7659106460369408
2304,Greece,GRC,1998,1908729,656750,114789,728612,1500151,0.7859423731708378
2305,Greece,GRC,1999,1948804,659982,115620,768803,1544405,0.792488623791823
2306,Greece,GRC,2000,1970200,662721,116350,789021,1568092,0.7959049842655568
2307,Greece,GRC,2001,1974474,664772,117067,789725,1571564,0.7959405897469402
2308,Greece,GRC,2002,1965450,664322,117488,780173,1561983,0.7947202930626575
2309,Greece,GRC,1997,1859699,652015,113681,681262,1446958,0.7780603205142338
2310,Greenland,GRL,2011,9735,2942,404,3734,7080,0.7272727272727273
2311,Greenland,GRL,2007,9714,2915,397,3750,7062,0.7269919703520692
2312,Greenland,GRL,2008,9699,2912,398,3734,7044,0.7262604392205382
2313,Greenland,GRL,2009,9687,2912,399,3722,7033,0.7260245690100134
2314,Greenland,GRL,2010,9715,2925,401,3732,7058,0.7265054040144107
2315,Greenland,GRL,2012,9727,2957,405,3718,7080,0.7278708748843425
2316,Greenland,GRL,2019,9383,2946,400,3477,6823,0.7271661515506768
2317,Greenland,GRL,2014,9615,2960,404,3647,7011,0.7291731669266771
2318,Greenland,GRL,2015,9568,2955,402,3618,6975,0.728992474916388
2319,Greenland,GRL,2016,9538,2952,401,3609,6962,0.7299224156007549
2320,Greenland,GRL,2017,9524,2952,400,3608,6960,0.7307853842923141
2321,Greenland,GRL,2018,9474,2951,400,3568,6919,0.7303145450707199
2322,Greenland,GRL,2006,9740,2922,396,3772,7090,0.7279260780287474
2323,Greenland,GRL,2013,9676,2960,405,3684,7049,0.7285035138486978
2324,Greenland,GRL,2005,9752,2920,395,3779,7094,0.7274405250205086
2325,Greenland,GRL,2004,9727,2906,390,3771,7067,0.7265343888146396
2326,Greenland,GRL,2003,9684,2888,381,3760,7029,0.7258364312267658
2327,Greenland,GRL,1991,9694,2797,360,3966,7123,0.734784402723334
2328,Greenland,GRL,1992,9618,2783,356,3925,7064,0.7344562279060096
2329,Greenland,GRL,1993,9559,2771,353,3890,7014,0.733758761376713
2330,Greenland,GRL,1994,9554,2775,353,3871,6999,0.7325727444002512
2331,Greenland,GRL,1995,9572,2789,353,3860,7002,0.7315085666527371
2332,Greenland,GRL,1996,9579,2799,354,3840,6993,0.7300344503601629
2333,Greenland,GRL,1990,9718,2797,362,3978,7137,0.7344103725046306
2334,Greenland,GRL,1998,9569,2818,357,3796,6971,0.7284982756818894
2335,Greenland,GRL,1999,9561,2825,358,3767,6950,0.7269114109402782
2336,Greenland,GRL,2000,9569,2834,360,3750,6944,0.7256766642282371
2337,Greenland,GRL,2001,9602,2850,365,3752,6967,0.7255780045823786
2338,Greenland,GRL,2002,9646,2871,373,3757,7001,0.7257930748496786
2339,Greenland,GRL,1997,9575,2809,356,3818,6983,0.7292950391644909
2340,Grenada,GRD,2007,15151,4663,1044,3536,9243,0.6100587419972279
2341,Grenada,GRD,2008,15121,4678,1045,3523,9246,0.6114674955360095
2342,Grenada,GRD,2009,15079,4687,1045,3509,9241,0.6128390476822071
2343,Grenada,GRD,2010,15036,4690,1044,3504,9238,0.61439212556531
2344,Grenada,GRD,2011,15007,4693,1043,3513,9249,0.6163123875524755
2345,Grenada,GRD,2012,14986,4704,1043,3527,9274,0.6188442546376618
2346,Grenada,GRD,2015,14942,4733,1043,3578,9354,0.6260206130370767
2347,Grenada,GRD,2014,14961,4728,1043,3562,9333,0.6238219370362944
2348,Grenada,GRD,2016,14909,4730,1042,3591,9363,0.6280099268897981
2349,Grenada,GRD,2017,14872,4725,1042,3603,9370,0.6300430338891877
2350,Grenada,GRD,2018,14851,4723,1041,3625,9389,0.6322133189684196
2351,Grenada,GRD,2006,15160,4643,1042,3541,9226,0.608575197889182
2352,Grenada,GRD,2013,14975,4717,1043,3544,9304,0.6213021702838063
2353,Grenada,GRD,2005,15136,4620,1037,3527,9184,0.6067653276955602
2354,Grenada,GRD,2019,14836,4722,1040,3659,9421,0.6350094365057967
2355,Grenada,GRD,2003,14945,4546,1017,3437,9000,0.6022080963532954
2356,Grenada,GRD,1990,11352,3330,694,2380,6404,0.5641296687808316
2357,Grenada,GRD,1991,11411,3351,702,2388,6441,0.56445535010078
2358,Grenada,GRD,1992,11548,3398,716,2417,6531,0.5655524766193281
2359,Grenada,GRD,1993,11750,3465,735,2466,6666,0.5673191489361702
2360,Grenada,GRD,1994,12012,3552,758,2530,6840,0.5694305694305695
2361,Grenada,GRD,1995,12323,3656,786,2612,7054,0.5724255457275014
2362,Grenada,GRD,2004,15064,4590,1029,3491,9110,0.604753053637812
2363,Grenada,GRD,1997,13058,3904,850,2824,7578,0.580333894930311
2364,Grenada,GRD,1998,13459,4037,884,2945,7866,0.584441637565941
2365,Grenada,GRD,1999,13846,4170,918,3065,8153,0.5888343203813375
2366,Grenada,GRD,2000,14210,4294,950,3180,8424,0.5928219563687543
2367,Grenada,GRD,2001,14519,4401,978,3280,8659,0.596390936014877
2368,Grenada,GRD,2002,14763,4485,1000,3367,8852,0.5996071259229154
2369,Grenada,GRD,1996,12673,3775,817,2711,7303,0.5762644993292827
2370,Guam,GUM,2006,17783,6389,465,5082,11936,0.6712028341674633
2371,Guam,GUM,2007,17898,6439,468,5142,12049,0.673203709911722
2372,Guam,GUM,2008,18010,6490,471,5199,12160,0.6751804553026096
2373,Guam,GUM,2009,18119,6538,474,5254,12266,0.6769689276450135
2374,Guam,GUM,2010,18211,6580,478,5301,12359,0.6786557575091977
2375,Guam,GUM,2011,18305,6620,481,5350,12451,0.6801966675771647
2376,Guam,GUM,2015,18682,6792,493,5523,12808,0.6855797023873247
2377,Guam,GUM,2013,18494,6710,487,5440,12637,0.6833026927652212
2378,Guam,GUM,2014,18591,6754,490,5484,12728,0.6846323489860685
2379,Guam,GUM,2016,18763,6815,495,5562,12872,0.6860310184938443
2380,Guam,GUM,2017,18841,6839,498,5594,12931,0.6863223820391698
2381,Guam,GUM,2018,18950,6887,500,5629,13016,0.6868601583113456
2382,Guam,GUM,2005,17667,6344,462,5031,11837,0.6700062262976171
2383,Guam,GUM,2012,18399,6665,484,5395,12544,0.6817761834882331
2384,Guam,GUM,2019,19073,6951,503,5662,13116,0.6876736748282913
2385,Guam,GUM,2004,17554,6305,458,4984,11747,0.6691922069044093
2386,Guam,GUM,2002,17296,6224,451,4887,11562,0.6684782608695652
2387,Guam,GUM,2003,17433,6266,455,4936,11657,0.6686743532381116
2388,Guam,GUM,1990,14574,5147,377,4123,9647,0.6619322080417182
2389,Guam,GUM,1991,14874,5254,385,4217,9856,0.6626327820357671
2390,Guam,GUM,1992,15158,5360,393,4302,10055,0.6633460878743898
2391,Guam,GUM,1994,15690,5562,408,4457,10427,0.6645634161886552
2392,Guam,GUM,1995,15938,5660,414,4527,10601,0.6651399171790688
2393,Guam,GUM,1993,15430,5462,401,4383,10246,0.6640311082307194
2394,Guam,GUM,1997,16394,5853,426,4644,10923,0.6662803464682201
2395,Guam,GUM,1998,16598,5943,432,4690,11065,0.6666465839257741
2396,Guam,GUM,1999,16801,6031,437,4739,11207,0.667043628355455
2397,Guam,GUM,2000,16986,6109,442,4788,11339,0.6675497468503473
2398,Guam,GUM,2001,17153,6172,447,4838,11457,0.6679298081968169
2399,Guam,GUM,1996,16178,5758,421,4590,10769,0.665657065150204
2400,Guatemala,GTM,2011,1797226,588175,108933,466504,1163612,0.6474489018075634
2401,Guatemala,GTM,2007,1606376,511507,94479,425215,1031201,0.6419424842004612
2402,Guatemala,GTM,2008,1654019,530565,97998,435035,1063598,0.6430385624348934
2403,Guatemala,GTM,2009,1701520,549744,101576,444923,1096243,0.6442727678781325
2404,Guatemala,GTM,2010,1749339,568783,105228,455762,1129773,0.6458285100829513
2405,Guatemala,GTM,2012,1843846,608325,112678,476029,1197032,0.6492038922990315
2406,Guatemala,GTM,2006,1557435,492919,91036,414101,998056,0.6408331647869735
2407,Guatemala,GTM,2014,1938412,648950,120183,497109,1266242,0.6532367731937276
2408,Guatemala,GTM,2015,1987777,668391,123931,511212,1303534,0.6557747674915244
2409,Guatemala,GTM,2016,2041004,687362,127656,528803,1343821,0.6584117424561637
2410,Guatemala,GTM,2017,2093662,705846,131369,546807,1384022,0.6610532168038585
2411,Guatemala,GTM,2018,2141936,723301,135054,561899,1420254,0.6630702317903056
2412,Guatemala,GTM,2013,1890812,628760,116434,485816,1231010,0.6510483326740046
2413,Guatemala,GTM,2005,1507912,475110,87685,401300,964095,0.6393576017698646
2414,Guatemala,GTM,2019,2186540,739845,138688,574688,1453221,0.664621273793299
2415,Guatemala,GTM,2003,1406321,440813,81281,373260,895354,0.63666403331814
2416,Guatemala,GTM,1990,884272,277484,51214,215100,543798,0.6149668880163569
2417,Guatemala,GTM,1991,911445,285749,52749,223478,561976,0.6165769739260186
2418,Guatemala,GTM,1992,940249,294489,54379,232403,581271,0.6182096444665189
2419,Guatemala,GTM,1993,970933,303829,56129,241731,601689,0.6197018743826814
2420,Guatemala,GTM,1994,1003498,313902,58019,251574,623495,0.6213216169837907
2421,Guatemala,GTM,1995,1039009,324898,60081,262200,647179,0.6228810337542793
2422,Guatemala,GTM,2004,1457169,457840,84425,387261,929526,0.6378985553494482
2423,Guatemala,GTM,1997,1120185,349539,64670,288430,702639,0.6272526413047845
2424,Guatemala,GTM,1998,1164442,362974,67146,303557,733677,0.6300674486148731
2425,Guatemala,GTM,1999,1210670,377187,69750,318640,765577,0.6323581157540866
2426,Guatemala,GTM,2000,1258126,392161,72483,332686,797330,0.6337441559907354
2427,Guatemala,GTM,2001,1306400,407824,75314,345882,829020,0.6345835884874464
2428,Guatemala,GTM,2002,1355947,424110,78247,359328,861685,0.635485752761723
2429,Guatemala,GTM,1996,1077930,336820,62310,274277,673407,0.6247223845704266
2430,Guinea,GIN,2007,929341,271820,38360,284003,594183,0.6393595031317891
2431,Guinea,GIN,2009,977940,285645,40456,298575,624676,0.6387672045319753
2432,Guinea,GIN,2010,1003382,293140,41558,306009,640707,0.6385474325830043
2433,Guinea,GIN,2011,1029532,301092,42681,313799,657572,0.6387096272869615
2434,Guinea,GIN,2012,1055894,309529,43835,321837,675201,0.6394590744904318
2435,Guinea,GIN,2015,1139028,336928,47509,347736,732173,0.6428050934656567
2436,Guinea,GIN,2014,1110715,327626,46254,338795,712675,0.6416362433207439
2437,Guinea,GIN,2006,907426,265572,37424,277538,580534,0.6397590547328377
2438,Guinea,GIN,2016,1168399,346903,48840,357218,752961,0.6444382441272203
2439,Guinea,GIN,2017,1199598,357422,50273,367455,775150,0.6461748018919672
2440,Guinea,GIN,2018,1232862,367887,51787,378324,797998,0.6472727685661493
2441,Guinea,GIN,2019,1267531,378357,53371,390002,821730,0.6482918366493601
2442,Guinea,GIN,2013,1083087,318432,45029,330265,693726,0.6405081032271646
2443,Guinea,GIN,2005,887012,259640,36551,271487,567678,0.63998908695711
2444,Guinea,GIN,2008,952992,278563,39384,291101,609048,0.6390903596252644
2445,Guinea,GIN,2003,850648,248462,34982,260476,543920,0.6394184198399337
2446,Guinea,GIN,1990,609086,177200,25682,188808,391690,0.6430783173476323
2447,Guinea,GIN,1991,633359,184088,26678,195964,406730,0.6421792379993021
2448,Guinea,GIN,1992,652649,189477,27430,201646,418553,0.6413140907287072
2449,Guinea,GIN,1993,673647,195479,28256,207771,431506,0.6405520992448567
2450,Guinea,GIN,1994,698324,202654,29242,214907,446803,0.6398219164743013
2451,Guinea,GIN,1995,716505,207865,29913,220306,458084,0.6393311979679137
2452,Guinea,GIN,2004,868025,253840,35724,265694,555258,0.639679732726592
2453,Guinea,GIN,1997,760466,220972,31610,233298,485880,0.6389240281616798
2454,Guinea,GIN,1998,779922,226822,32330,239043,498195,0.6387754160031388
2455,Guinea,GIN,1999,788581,229428,32562,241863,503853,0.638936266534446
2456,Guinea,GIN,2000,797006,231964,32808,244595,509367,0.6391005839353782
2457,Guinea,GIN,2001,811795,236503,33376,249026,518905,0.6392069426394594
2458,Guinea,GIN,2002,831983,242736,34209,254970,531915,0.6393339767759678
2459,Guinea,GIN,1996,733787,213001,30556,225523,469080,0.6392590765440107
2460,Guinea-Bissau,GNB,2006,141681,39372,5959,43646,88977,0.6280094014017406
2461,Guinea-Bissau,GNB,2007,145164,40303,6117,44813,91233,0.6284822683309912
2462,Guinea-Bissau,GNB,2008,148792,41266,6280,46017,93563,0.6288174095381472
2463,Guinea-Bissau,GNB,2009,152507,42265,6448,47292,96005,0.6295120879697326
2464,Guinea-Bissau,GNB,2010,156197,43309,6620,48549,98478,0.6304730564607515
2465,Guinea-Bissau,GNB,2011,160029,44424,6796,49881,101101,0.6317667422779621
2466,Guinea-Bissau,GNB,2015,175974,49448,7551,55710,112709,0.6404866628024595
2467,Guinea-Bissau,GNB,2013,167779,46870,7162,52702,106734,0.6361582796416715
2468,Guinea-Bissau,GNB,2014,171811,48155,7354,54180,109689,0.6384282729278102
2469,Guinea-Bissau,GNB,2016,180283,50808,7754,57295,115857,0.642639627696455
2470,Guinea-Bissau,GNB,2017,184821,52190,7964,59006,119160,0.6447319298131706
2471,Guinea-Bissau,GNB,2018,189340,53494,8181,60741,122416,0.6465406147670857
2472,Guinea-Bissau,GNB,2005,138290,38460,5805,42513,86778,0.6275074119603731
2473,Guinea-Bissau,GNB,2012,163888,45618,6976,51270,103864,0.6337498779654398
2474,Guinea-Bissau,GNB,2019,194068,54748,8406,62528,125682,0.647618360574644
2475,Guinea-Bissau,GNB,2004,134937,37560,5655,41430,84645,0.6272927366104182
2476,Guinea-Bissau,GNB,2002,128386,35811,5367,39300,80478,0.626844048416494
2477,Guinea-Bissau,GNB,1990,97405,26975,4036,29713,60724,0.6234176890303372
2478,Guinea-Bissau,GNB,1991,99516,27597,4125,30311,62033,0.623346999477471
2479,Guinea-Bissau,GNB,1992,101668,28239,4217,30939,63395,0.6235491993547626
2480,Guinea-Bissau,GNB,1993,103959,28904,4313,31612,64829,0.6236016121740301
2481,Guinea-Bissau,GNB,1994,106311,29594,4413,32294,66301,0.6236513625118756
2482,Guinea-Bissau,GNB,1995,108786,30310,4516,33023,67849,0.6236923868880186
2483,Guinea-Bissau,GNB,2003,131653,36677,5508,40355,82540,0.6269511518917154
2484,Guinea-Bissau,GNB,1997,114007,31796,4737,34651,71184,0.6243827133421632
2485,Guinea-Bissau,GNB,1998,116753,32556,4853,35542,72951,0.6248319101008111
2486,Guinea-Bissau,GNB,1999,119465,33329,4972,36420,74721,0.6254635248817645
2487,Guinea-Bissau,GNB,2000,122291,34134,5098,37344,76576,0.6261785413480959
2488,Guinea-Bissau,GNB,2001,125293,34964,5230,38299,78493,0.6264755413311198
2489,Guinea-Bissau,GNB,1996,111384,31044,4625,33809,69478,0.6237700208288444
2490,Guyana,GUY,2006,116519,31856,6352,35351,73559,0.631304765746359
2491,Guyana,GUY,2007,116578,31965,6372,35492,73829,0.633301308994836
2492,Guyana,GUY,2008,116611,32072,6398,35634,74104,0.6354803577707078
2493,Guyana,GUY,2009,116541,32176,6427,35778,74381,0.6382389030469964
2494,Guyana,GUY,2010,116498,32266,6458,35959,74683,0.6410667994300331
2495,Guyana,GUY,2011,116362,32359,6488,36134,74981,0.6443770303019887
2496,Guyana,GUY,2014,115734,32682,6569,36471,75722,0.6542761850450171
2497,Guyana,GUY,2013,115943,32583,6544,36352,75479,0.651000922867271
2498,Guyana,GUY,2015,115539,32745,6592,36614,75951,0.6573624490431802
2499,Guyana,GUY,2016,116724,33048,6697,37244,76989,0.6595815770535622
2500,Guyana,GUY,2017,119358,33733,6889,38279,78901,0.6610449236749946
2501,Guyana,GUY,2005,116373,31757,6338,35212,73307,0.6299313414623667
2502,Guyana,GUY,2019,120146,34431,7002,38368,79801,0.6642002230619413
2503,Guyana,GUY,2012,116191,32471,6517,36263,75251,0.6476491294506459
2504,Guyana,GUY,2018,120530,34219,6992,38671,79882,0.6627561602920434
2505,Guyana,GUY,2004,116158,31662,6329,35015,73006,0.6285060004476661
2506,Guyana,GUY,2002,115275,31469,6321,34289,72079,0.62527868141401
2507,Guyana,GUY,2003,115766,31563,6323,34677,72563,0.6268075255256292
2508,Guyana,GUY,1990,112901,31072,6225,30394,67691,0.5995606770533476
2509,Guyana,GUY,1991,112743,31062,6243,30580,67885,0.6021216394809434
2510,Guyana,GUY,1992,112643,31072,6264,30802,68138,0.6049022131867937
2511,Guyana,GUY,1994,112675,31110,6301,31282,68693,0.6096560905258487
2512,Guyana,GUY,1995,112741,31134,6315,31509,68958,0.6116497103981693
2513,Guyana,GUY,1993,112659,31090,6284,31053,68427,0.6073815673847629
2514,Guyana,GUY,1997,113110,31172,6325,32220,69717,0.6163646008310494
2515,Guyana,GUY,1998,113470,31201,6325,32694,70220,0.6188419846655504
2516,Guyana,GUY,1999,113877,31247,6324,33153,70724,0.6210560517049096
2517,Guyana,GUY,2000,114325,31310,6323,33539,71172,0.6225410015307238
2518,Guyana,GUY,2001,114779,31383,6321,33899,71603,0.6238336281027017
2519,Guyana,GUY,1996,112867,31153,6322,31804,69279,0.613810945626268
2520,Haiti,HTI,2011,1495055,440093,82693,325862,848648,0.5676366421302226
2521,Haiti,HTI,2007,1382585,401110,76010,301788,778908,0.5633707873295313
2522,Haiti,HTI,2008,1418023,412701,78141,308846,799688,0.5639457187929956
2523,Haiti,HTI,2009,1454405,424567,80274,316333,821174,0.5646116453120005
2524,Haiti,HTI,2010,1474766,432103,81503,320816,834422,0.5657995912571893
2525,Haiti,HTI,2012,1532357,453534,84796,334668,872998,0.5697092779293598
2526,Haiti,HTI,2006,1348010,389895,73888,294537,758320,0.5625477555804482
2527,Haiti,HTI,2014,1609852,481590,89088,353058,923736,0.5738018153221538
2528,Haiti,HTI,2015,1647985,495034,91284,362419,948737,0.5756951671283416
2529,Haiti,HTI,2016,1686417,507782,93502,372486,973770,0.5774194638692566
2530,Haiti,HTI,2017,1725016,520594,95757,382769,999120,0.5791946277599744
2531,Haiti,HTI,2018,1764423,534217,98062,392704,1024983,0.580916820966401
2532,Haiti,HTI,2013,1570547,467547,86927,343718,898192,0.5718975618048998
2533,Haiti,HTI,2005,1314215,379144,71772,287008,737924,0.5614941238686212
2534,Haiti,HTI,2019,1803935,548722,100409,402655,1051786,0.5830509414141862
2535,Haiti,HTI,2003,1248703,358558,67604,271307,697469,0.5585547564152564
2536,Haiti,HTI,1990,865692,246990,45643,187723,480356,0.5548809507307448
2537,Haiti,HTI,1991,890522,253635,46866,192166,492667,0.5532339459328349
2538,Haiti,HTI,1992,916641,260617,48163,196825,505605,0.5515845352760786
2539,Haiti,HTI,1993,943332,267926,49532,201795,519253,0.5504456543401475
2540,Haiti,HTI,1994,970957,275577,50976,207146,533699,0.5496628583964068
2541,Haiti,HTI,1995,999181,283666,52512,213093,549271,0.5497212216805564
2542,Haiti,HTI,2004,1281440,368799,69681,279219,717699,0.5600722624547384
2543,Haiti,HTI,1997,1057899,300719,55847,226022,582588,0.550702855376553
2544,Haiti,HTI,1998,1088257,309617,57642,233075,600334,0.5516472671436986
2545,Haiti,HTI,1999,1119420,318821,59520,240374,618715,0.5527103321362848
2546,Haiti,HTI,2000,1151334,328377,61471,247851,637699,0.5538783706552572
2547,Haiti,HTI,2001,1183558,338238,63476,255649,657363,0.5554125780063165
2548,Haiti,HTI,2002,1215962,348313,65523,263410,677246,0.556963128781985
2549,Haiti,HTI,1996,1028356,292088,54139,219392,565619,0.550022560280681
2550,Honduras,HND,2007,845299,271588,53698,182334,507620,0.6005212356811022
2551,Honduras,HND,2008,871252,281215,55515,188930,525660,0.6033386436989527
2552,Honduras,HND,2009,897379,291022,57378,195585,543985,0.6061931469312297
2553,Honduras,HND,2010,923838,300806,59289,202454,562549,0.6089260238266883
2554,Honduras,HND,2011,950340,310786,61223,209536,581545,0.6119336237557085
2555,Honduras,HND,2012,976681,321111,63155,216559,600825,0.6151701527929795
2556,Honduras,HND,2015,1055570,351947,68972,237901,658820,0.6241367223395891
2557,Honduras,HND,2014,1029351,341916,67016,230593,639525,0.6212895309763142
2558,Honduras,HND,2016,1082108,361986,70947,245341,678274,0.6268080450380183
2559,Honduras,HND,2017,1108992,371871,72946,252917,697734,0.6291605349722992
2560,Honduras,HND,2018,1134855,381360,74939,260194,716493,0.6313520229456626
2561,Honduras,HND,2006,819909,262325,51926,175914,490165,0.5978285395086528
2562,Honduras,HND,2013,1003138,331541,65077,223546,620164,0.6182240130470583
2563,Honduras,HND,2005,795603,253615,50197,169775,473587,0.5952554226165563
2564,Honduras,HND,2019,1160229,390766,76925,267211,734902,0.63341116279631
2565,Honduras,HND,2003,747371,237299,46887,157427,441613,0.590888594821046
2566,Honduras,HND,1990,500007,155817,30165,98841,284823,0.569638025067649
2567,Honduras,HND,1991,516629,161392,31207,102155,294754,0.5705332066144176
2568,Honduras,HND,1992,533378,167057,32290,105689,305036,0.5718946038269295
2569,Honduras,HND,1993,550672,172799,33414,109360,315573,0.5730689049016474
2570,Honduras,HND,1994,568194,178635,34584,113229,326448,0.5745361619446879
2571,Honduras,HND,1995,586146,184530,35795,117283,337608,0.575979363503291
2572,Honduras,HND,2004,771350,245330,48512,163575,457417,0.5930083619627925
2573,Honduras,HND,1997,622839,196417,38327,125970,360714,0.5791448512376393
2574,Honduras,HND,1998,641100,202312,39603,130558,372473,0.580990485103728
2575,Honduras,HND,1999,659913,208427,40921,135301,384649,0.5828783491157168
2576,Honduras,HND,2000,680229,215108,42341,140445,397894,0.5849412477268684
2577,Honduras,HND,2001,701554,222150,43804,145816,411770,0.58693985067436
2578,Honduras,HND,2002,723984,229561,45318,151496,426375,0.5889287608565935
2579,Honduras,HND,1996,604198,190435,37042,121462,348939,0.5775242552937944
2580,Hungary,HUN,2006,1191464,393322,62235,369390,824947,0.6923809699663607
2581,Hungary,HUN,2007,1186328,393106,62144,366828,822078,0.692960125698795
2582,Hungary,HUN,2008,1181341,392855,62018,364547,819420,0.6936354532687852
2583,Hungary,HUN,2009,1176657,392502,61880,362755,817137,0.6944564133812997
2584,Hungary,HUN,2010,1172406,391865,61728,361338,814931,0.6950928262052566
2585,Hungary,HUN,2011,1168798,390718,61566,360910,813194,0.6957523883511094
2586,Hungary,HUN,2015,1155195,383749,60695,362115,806559,0.6982016023268799
2587,Hungary,HUN,2013,1161925,387285,61173,361197,809655,0.696822084041569
2588,Hungary,HUN,2014,1158766,385467,60943,361775,808185,0.6974531527504259
2589,Hungary,HUN,2016,1151797,381291,60445,363225,804961,0.6988740203351806
2590,Hungary,HUN,2017,1148180,379005,60186,363917,803108,0.6994617568673901
2591,Hungary,HUN,2018,1143727,377808,59881,362730,800419,0.6998339638742462
2592,Hungary,HUN,2005,1196295,393594,62315,371724,827633,0.6918301923856573
2593,Hungary,HUN,2012,1165155,389108,61387,360811,811306,0.6963073582484733
2594,Hungary,HUN,2019,1138329,377145,59555,360365,797065,0.7002061794085892
2595,Hungary,HUN,2004,1201159,393834,62385,374000,830219,0.6911816004375774
2596,Hungary,HUN,2002,1211054,393967,62483,379178,835628,0.6900006110379884
2597,Hungary,HUN,2003,1206003,393945,62446,376585,832976,0.6906914825253336
2598,Hungary,HUN,1990,1255240,390423,61312,410562,862297,0.6869578725980688
2599,Hungary,HUN,1991,1254954,391094,61447,410007,862548,0.6873144354295058
2600,Hungary,HUN,1992,1253408,391582,61587,408775,861944,0.6876803084071588
2601,Hungary,HUN,1994,1248227,392121,61857,406029,860007,0.688982853279091
2602,Hungary,HUN,1995,1245718,392438,61998,404725,859161,0.6896914068834198
2603,Hungary,HUN,1993,1250873,391847,61710,407426,860983,0.6883056873079841
2604,Hungary,HUN,1997,1237292,393200,62261,398307,853768,0.6900295160721964
2605,Hungary,HUN,1998,1230819,393393,62335,393046,848774,0.6896009892599968
2606,Hungary,HUN,1999,1224458,393470,62383,388331,844184,0.6894348356578992
2607,Hungary,HUN,2000,1219394,393595,62426,384439,840460,0.6892440015286282
2608,Hungary,HUN,2001,1215389,393826,62467,381774,838067,0.6895463098645783
2609,Hungary,HUN,1996,1242287,392836,62134,402399,857369,0.6901537245419134
2610,Iceland,ISL,2011,43595,16790,3156,10158,30104,0.6905379057231333
2611,Iceland,ISL,2007,42248,16184,3015,9853,29052,0.687653853436849
2612,Iceland,ISL,2008,42939,16465,3081,9982,29528,0.6876732108339738
2613,Iceland,ISL,2009,43350,16648,3124,10063,29835,0.6882352941176471
2614,Iceland,ISL,2010,43492,16727,3143,10105,29975,0.6892072105214753
2615,Iceland,ISL,2012,43789,16887,3175,10241,30303,0.69202311082692
2616,Iceland,ISL,2006,41449,15867,2944,9705,28516,0.6879779970566238
2617,Iceland,ISL,2014,44597,17236,3243,10513,30992,0.6949346368589815
2618,Iceland,ISL,2015,45194,17467,3288,10673,31428,0.695402044519184
2619,Iceland,ISL,2016,45800,17685,3336,10831,31852,0.6954585152838428
2620,Iceland,ISL,2017,46397,17898,3385,10988,32271,0.6955406599564627
2621,Iceland,ISL,2018,46967,18102,3426,11165,32693,0.6960844848510657
2622,Iceland,ISL,2013,44107,17034,3203,10358,30595,0.6936540685152016
2623,Iceland,ISL,2005,40721,15579,2878,9567,28024,0.6881952800766189
2624,Iceland,ISL,2019,47521,18295,3463,11377,33135,0.6972706803308011
2625,Iceland,ISL,2003,39748,15175,2771,9397,27343,0.6879088256012881
2626,Iceland,ISL,1990,35078,13191,2355,8488,24034,0.6851587889845487
2627,Iceland,ISL,1991,35436,13346,2384,8552,24282,0.6852353538774127
2628,Iceland,ISL,1992,35778,13495,2413,8615,24523,0.685421208563922
2629,Iceland,ISL,1993,36107,13633,2438,8673,24744,0.6852964799069432
2630,Iceland,ISL,1994,36419,13764,2462,8734,24960,0.685356544660754
2631,Iceland,ISL,1995,36671,13872,2484,8782,25138,0.6855008044503831
2632,Iceland,ISL,2004,40170,15356,2823,9464,27643,0.688150360965895
2633,Iceland,ISL,1997,37175,14084,2530,8894,25508,0.6861600537995965
2634,Iceland,ISL,1998,37536,14230,2561,8974,25765,0.6864077152600171
2635,Iceland,ISL,1999,37995,14423,2597,9074,26094,0.6867745756020529
2636,Iceland,ISL,2000,38482,14625,2636,9185,26446,0.6872303934306949
2637,Iceland,ISL,2001,38981,14834,2679,9283,26796,0.6874118160129293
2638,Iceland,ISL,2002,39390,15013,2724,9348,27085,0.6876110687991877
2639,Iceland,ISL,1996,36909,13974,2506,8833,25313,0.6858218862608036
2640,India,IND,2007,159567725,30761909,3886672,44178916,78827497,0.4940065229356375
2641,India,IND,2009,162693852,33999688,4069701,41542419,79611808,0.48933507333762066
2642,India,IND,2010,165033039,35234436,4163525,41531220,80929181,0.49038169260156445
2643,India,IND,2011,167976789,36197803,4257734,42443838,82899375,0.49351684535415186
2644,India,IND,2012,170986546,37150579,4352549,43420959,84924087,0.49667116499329717
2645,India,IND,2015,179696402,39878428,4641193,46523772,91043393,0.5066511737947875
2646,India,IND,2014,176935436,38999063,4544403,45488687,89032153,0.5031900619387515
2647,India,IND,2006,157729299,29266691,3796632,45135572,78198895,0.4957791323221439
2648,India,IND,2016,182305698,40750234,4737049,47562311,93049594,0.5104042003119398
2649,India,IND,2017,184811945,41569236,4832686,48602578,95004500,0.5140603871681563
2650,India,IND,2018,186732831,41937101,4928032,49450603,96315736,0.5157943329204921
2651,India,IND,2019,187963709,41805549,5022935,50059379,96887863,0.5154604764688911
2652,India,IND,2013,174000099,38086589,4448082,44444032,86978703,0.49987731903531846
2653,India,IND,2005,155130071,28171128,3707275,44887371,76765774,0.49484779775547194
2654,India,IND,2008,161054253,32421353,3977489,42712778,79111620,0.4912109958375331
2655,India,IND,2003,148383398,26556295,3531911,42254957,72343163,0.4875421642520951
2656,India,IND,1990,113786975,22383793,2606323,27545104,52535220,0.4616980106905909
2657,India,IND,1991,116954047,22780892,2665347,29371806,54818045,0.4687143917302836
2658,India,IND,1992,120055188,23155592,2725513,31098851,56979956,0.47461469137010553
2659,India,IND,1993,123055651,23518017,2787332,32672446,58977795,0.47927742058753564
2660,India,IND,1994,125914892,23878498,2851320,34023942,60753760,0.48249860707500747
2661,India,IND,1995,128545401,24244877,2917735,35067058,62229670,0.4841065453597986
2662,India,IND,2004,151841769,27351474,3618672,43663742,74633888,0.49152409440119205
2663,India,IND,1997,132642190,24344133,3058813,36420527,63823473,0.48117022947223653
2664,India,IND,1998,134376783,24184163,3132060,36963411,64279634,0.47835371977910796
2665,India,IND,1999,136291877,24158456,3207650,37574292,64940398,0.47648032611657404
2666,India,IND,2000,138718915,24490264,3285482,38385552,66161298,0.47694503665920396
2667,India,IND,2001,141682602,25114810,3365604,39492874,67973288,0.4797574793269254
2668,India,IND,2002,144944519,25806922,3447669,40819417,70074008,0.48345400352806717
2669,India,IND,1996,130787045,24427372,2987310,35826332,63241014,0.48354188291355615
2670,Indonesia,IDN,2006,23994502,7796624,751418,5205270,13753312,0.5731859740202151
2671,Indonesia,IDN,2007,24255959,7926834,763316,5279752,13969902,0.575936906885438
2672,Indonesia,IDN,2008,24507428,8063204,775199,5352864,14191267,0.579059826269815
2673,Indonesia,IDN,2009,24758565,8201345,787096,5429432,14417873,0.5823387987147074
2674,Indonesia,IDN,2010,25017592,8336668,799037,5517289,14652994,0.5857076092695093
2675,Indonesia,IDN,2011,25289503,8473847,811020,5618834,14903701,0.589323601970351
2676,Indonesia,IDN,2015,26398837,9051765,859945,6074387,15986097,0.6055606540545707
2677,Indonesia,IDN,2013,25848716,8765790,835328,5850034,15451152,0.5977531727301271
2678,Indonesia,IDN,2014,26122601,8911883,847606,5965388,15724877,0.6019644445053538
2679,Indonesia,IDN,2016,26666914,9195170,872277,6164628,16232075,0.6086971668337776
2680,Indonesia,IDN,2017,26928883,9332446,884678,6256963,16474087,0.6117627307452745
2681,Indonesia,IDN,2018,27214355,9459474,897061,6396089,16752624,0.6155804170262349
2682,Indonesia,IDN,2005,23705131,7676312,739436,5121758,13537506,0.5710791473795273
2683,Indonesia,IDN,2012,25568175,8618282,823130,5732003,15173415,0.5934492782531409
2684,Indonesia,IDN,2019,27535856,9586948,909393,6584642,17080983,0.6203178502967186
2685,Indonesia,IDN,2004,23403079,7566775,727591,5033284,13327650,0.5694827590848196
2686,Indonesia,IDN,2002,22760140,7350418,703180,4851873,12905471,0.567020721313665
2687,Indonesia,IDN,1990,19202555,5823129,543139,3774102,10140370,0.528073998486139
2688,Indonesia,IDN,1991,19482939,5965824,556630,3850441,10372895,0.5324091503853705
2689,Indonesia,IDN,1992,19764402,6106756,570153,3928576,10605485,0.5365952888430422
2690,Indonesia,IDN,1993,20045383,6245343,583753,4009590,10838686,0.5407073539078799
2691,Indonesia,IDN,1994,20332969,6380522,597399,4094921,11072842,0.5445757577262819
2692,Indonesia,IDN,1995,20625855,6510946,611045,4185730,11307721,0.5482304127513744
2693,Indonesia,IDN,2003,23086967,7459685,715597,4943506,13118788,0.5682334972800888
2694,Indonesia,IDN,1997,21219744,6763385,638169,4376972,11778526,0.5550738972157251
2695,Indonesia,IDN,1998,21514371,6886928,651549,4472914,12011391,0.558296173288078
2696,Indonesia,IDN,1999,21814571,7008027,664776,4569236,12242039,0.5611863281657017
2697,Indonesia,IDN,2000,22118891,7125905,677798,4663845,12467548,0.5636606283741803
2698,Indonesia,IDN,2001,22436449,7239809,690609,4758774,12689192,0.5655615110929542
2699,Indonesia,IDN,1996,20923227,6638009,624682,4281138,11543829,0.5517231639268646
2700,Iran,IRN,2007,14026309,5655876,644597,3517928,9818401,0.6999989091927178
2701,Iran,IRN,2008,14278657,5798806,658654,3663634,10121094,0.7088267475015332
2702,Iran,IRN,2009,14500541,5924186,670847,3797041,10392074,0.7166680194897556
2703,Iran,IRN,2010,14671801,6011491,680947,3901544,10593982,0.7220641828498083
2704,Iran,IRN,2011,14825230,6075592,689864,3992363,10757819,0.725642637584712
2705,Iran,IRN,2012,14998884,6142129,698235,4089557,10929921,0.7287156164418632
2706,Iran,IRN,2015,15493044,6327755,719256,4338028,11385039,0.7348484261711256
2707,Iran,IRN,2014,15345195,6270324,713051,4271205,11254580,0.7334269782821268
2708,Iran,IRN,2016,15536674,6269185,725294,4390542,11385021,0.7327836704303636
2709,Iran,IRN,2017,15569360,6200422,731366,4436640,11368428,0.7301795321066505
2710,Iran,IRN,2018,15658251,6259722,737586,4453313,11450621,0.7312835258548352
2711,Iran,IRN,2006,13788251,5522133,629939,3381069,9533141,0.6913959573262772
2712,Iran,IRN,2013,15178640,6208766,706113,4186005,11100884,0.7313490536701576
2713,Iran,IRN,2019,15711961,6353590,744024,4434190,11531804,0.7339506507176284
2714,Iran,IRN,2005,13580775,5411853,614685,3264733,9291271,0.6841488059407508
2715,Iran,IRN,2003,13181286,5201146,580787,3050038,8831971,0.6700386441808485
2716,Iran,IRN,2004,13392071,5313534,598576,3159866,9071976,0.6774139712968965
2717,Iran,IRN,1990,9997816,3755654,386373,2144617,6286644,0.6288017302978971
2718,Iran,IRN,1991,10127768,3827622,394748,2161433,6383803,0.6303267412918622
2719,Iran,IRN,1992,10167328,3866329,399608,2162171,6428108,0.6322317918729483
2720,Iran,IRN,1994,10602741,4078965,425026,2253557,6757548,0.6373397218700334
2721,Iran,IRN,1995,10861782,4198840,439614,2319444,6957898,0.6405853109554215
2722,Iran,IRN,1993,10346347,3958139,410585,2196805,6565529,0.6345745991314615
2723,Iran,IRN,1997,11483503,4451268,471683,2471058,7394009,0.6438809655903778
2724,Iran,IRN,1998,11845709,4588891,489939,2557371,7636201,0.6446385775642471
2725,Iran,IRN,1999,12193397,4724649,508647,2647828,7881124,0.6463435907155324
2726,Iran,IRN,2000,12480942,4847603,526554,2739686,8113843,0.6500986063391689
2727,Iran,IRN,2001,12707625,4958029,543491,2832880,8334400,0.6558581953748241
2728,Iran,IRN,2002,12936470,5074951,561499,2936272,8572722,0.6626786132538475
2729,Iran,IRN,1996,11150266,4321233,454921,2392392,7168546,0.6429035863359672
2730,Iraq,IRQ,2011,4819853,1803005,218494,1082066,3103565,0.643912791531194
2731,Iraq,IRQ,2007,4182017,1526930,183663,905698,2616291,0.6256050609072129
2732,Iraq,IRQ,2008,4324511,1589172,191423,941247,2721842,0.6293987921408918
2733,Iraq,IRQ,2009,4454355,1647211,198764,975313,2821288,0.6333774474643354
2734,Iraq,IRQ,2010,4611978,1715197,207674,1017116,2939987,0.6374676982414054
2735,Iraq,IRQ,2012,5042156,1897709,228871,1167577,3294157,0.6533231022602236
2736,Iraq,IRQ,2006,4056076,1471327,176819,873547,2521693,0.6217075321073865
2737,Iraq,IRQ,2014,5388412,2048917,244107,1333148,3626172,0.6729574501727039
2738,Iraq,IRQ,2015,5513823,2101636,250784,1389713,3742133,0.6786821049569418
2739,Iraq,IRQ,2016,5614682,2135608,257740,1430248,3823596,0.6809995650688676
2740,Iraq,IRQ,2017,5720253,2172031,264905,1470673,3907609,0.6831182117294462
2741,Iraq,IRQ,2018,5841751,2221979,272107,1511239,4005325,0.6856377479971331
2742,Iraq,IRQ,2019,5966138,2276807,279301,1548299,4104407,0.6879503960518513
2743,Iraq,IRQ,2013,5232221,1980566,237167,1255245,3472978,0.6637674517188781
2744,Iraq,IRQ,2005,4016398,1447943,174264,859785,2481992,0.6179646539013315
2745,Iraq,IRQ,2004,3994673,1432778,172711,849085,2454574,0.6144618095148213
2746,Iraq,IRQ,2003,3898900,1392873,167648,823487,2384008,0.611456564672087
2747,Iraq,IRQ,1991,2406856,853515,101320,556399,1511234,0.6278871689872597
2748,Iraq,IRQ,1992,2611251,916223,109308,598592,1624123,0.6219712314136021
2749,Iraq,IRQ,1993,2758342,959486,114713,627887,1702086,0.6170685143466619
2750,Iraq,IRQ,1994,2879707,996058,119226,652709,1767993,0.6139489191087844
2751,Iraq,IRQ,1995,2991197,1032642,123715,677629,1833986,0.6131277879725073
2752,Iraq,IRQ,1996,3098042,1072301,128506,696454,1897261,0.6124064812549346
2753,Iraq,IRQ,1990,2234866,802049,94808,521204,1418061,0.634517237275076
2754,Iraq,IRQ,1998,3308043,1160653,139032,710014,2009699,0.6075190074615112
2755,Iraq,IRQ,1999,3417854,1207181,144570,717516,2069267,0.6054287280849329
2756,Iraq,IRQ,2000,3538183,1254767,150275,736141,2141183,0.6051645717590074
2757,Iraq,IRQ,2001,3665058,1302374,156100,764819,2223293,0.6066187765650639
2758,Iraq,IRQ,2002,3780332,1346440,161652,793202,2301294,0.6087544691841881
2759,Iraq,IRQ,1997,3202864,1115360,133647,705517,1954524,0.610242582888315
2760,Ireland,IRL,2007,714118,296754,33733,203758,534245,0.7481186582609597
2761,Ireland,IRL,2008,732533,310564,34260,206880,551704,0.7531455920757154
2762,Ireland,IRL,2009,749145,322859,34727,209557,567143,0.7570537078936654
2763,Ireland,IRL,2010,761148,330732,35142,211861,577735,0.759031095135243
2764,Ireland,IRL,2011,769442,335267,35514,213136,583917,0.7588837105330876
2765,Ireland,IRL,2012,775662,339498,35842,212917,588257,0.7583934755086623
2766,Ireland,IRL,2015,790936,349572,36641,212502,598715,0.7569702226223107
2767,Ireland,IRL,2014,785830,346802,36401,211801,595004,0.7571663082346054
2768,Ireland,IRL,2016,799798,351221,36873,219226,607320,0.7593417337877815
2769,Ireland,IRL,2017,808330,352665,37119,225959,615743,0.7617470587507578
2770,Ireland,IRL,2018,810806,352074,37377,227602,617053,0.7610365488168563
2771,Ireland,IRL,2006,695954,284221,33143,200332,517696,0.7438652554622863
2772,Ireland,IRL,2013,780901,343402,36136,212189,591727,0.7577490616608251
2773,Ireland,IRL,2005,680862,275729,32492,196470,504691,0.7412529998736895
2774,Ireland,IRL,2019,809124,348241,37635,228118,613994,0.7588379531443883
2775,Ireland,IRL,2003,655750,265429,31122,188354,484905,0.7394662600076248
2776,Ireland,IRL,1990,573642,238700,25504,147251,411455,0.7172679127400016
2777,Ireland,IRL,1991,576824,240390,25670,148909,414969,0.7194031455001872
2778,Ireland,IRL,1992,580779,242249,25891,150826,418966,0.7213862760189332
2779,Ireland,IRL,1993,585429,244263,26169,152931,423363,0.7231671133476476
2780,Ireland,IRL,1994,590372,246412,26499,155258,428169,0.7252528913972884
2781,Ireland,IRL,1995,596015,248735,26880,157799,433414,0.727186396315529
2782,Ireland,IRL,2004,668061,270401,31816,192324,494541,0.7402632394347223
2783,Ireland,IRL,1997,606260,250281,27735,164622,442638,0.7301124929898064
2784,Ireland,IRL,1998,611052,250047,28201,168710,446958,0.7314565699809509
2785,Ireland,IRL,1999,616695,250530,28688,172811,452029,0.7329863222500588
2786,Ireland,IRL,2000,624245,252850,29210,176677,458737,0.73486691923844
2787,Ireland,IRL,2001,633726,256649,29794,180402,466845,0.7366669507010917
2788,Ireland,IRL,2002,644305,260828,30436,184391,475655,0.7382450857901149
2789,Ireland,IRL,1996,601477,250184,27297,160918,438399,0.7288707631380751
2790,Israel,ISR,2006,960697,230963,76090,331738,638791,0.6649245287536029
2791,Israel,ISR,2007,990132,248344,77673,337830,663847,0.6704631301685028
2792,Israel,ISR,2008,1022154,268829,79264,343932,692025,0.6770261623982297
2793,Israel,ISR,2009,1052314,287382,80853,349834,718069,0.6823714214578538
2794,Israel,ISR,2010,1076178,298718,82446,355462,736626,0.6844834218874573
2795,Israel,ISR,2011,1093630,304275,84093,358990,747358,0.6833737187165677
2796,Israel,ISR,2015,1153669,324385,90987,363273,778645,0.6749292908104491
2797,Israel,ISR,2013,1121764,314435,87558,359251,761244,0.6786133268673268
2798,Israel,ISR,2014,1136385,319336,89295,359635,768266,0.6760613700462431
2799,Israel,ISR,2016,1173646,328707,92658,368985,790350,0.6734143003938156
2800,Israel,ISR,2017,1194618,333243,94348,375278,802869,0.6720717417618017
2801,Israel,ISR,2018,1216760,339145,96076,383016,818237,0.6724719747526218
2802,Israel,ISR,2005,937818,221203,74514,325506,621223,0.6624131761173276
2803,Israel,ISR,2012,1107869,309436,85800,359474,754710,0.6812267515383137
2804,Israel,ISR,2019,1240267,345596,97794,391626,835016,0.6732550329888645
2805,Israel,ISR,2004,920070,216717,72950,319775,609442,0.6623865575445347
2806,Israel,ISR,2002,886132,208180,69796,309343,587319,0.6627895166860016
2807,Israel,ISR,2003,903117,212388,71373,314575,598336,0.6625232389601791
2808,Israel,ISR,1990,670082,182471,50525,209315,442311,0.6600848851334613
2809,Israel,ISR,1991,693290,188313,52151,220394,460858,0.6647405847480852
2810,Israel,ISR,1992,716552,193978,53769,231444,479191,0.6687456039477945
2811,Israel,ISR,1994,761684,204861,57007,251841,513709,0.6744384810498842
2812,Israel,ISR,1995,782776,210017,58627,260546,529190,0.6760426993162795
2813,Israel,ISR,1993,739440,199502,55381,241959,496842,0.6719165855241804
2814,Israel,ISR,1997,813218,208814,61849,276070,546733,0.6723080404024505
2815,Israel,ISR,1998,824376,203774,63461,283485,550720,0.6680446786417849
2816,Israel,ISR,1999,836142,199736,65060,290730,555526,0.6643919334275757
2817,Israel,ISR,2000,851380,200139,66640,297673,564452,0.6629848011463741
2818,Israel,ISR,2001,869341,204086,68220,304023,576329,0.6629492914748067
2819,Israel,ISR,1996,799972,211809,60238,268308,540355,0.6754673913586976
2820,Italy,ITA,2011,8989694,3545070,631537,2627450,6804057,0.7568730370577686
2821,Italy,ITA,2007,8648643,3232249,618651,2620209,6471109,0.7482224668077986
2822,Italy,ITA,2008,8759782,3348166,622651,2610569,6581386,0.7513184688842713
2823,Italy,ITA,2009,8863924,3452169,626257,2606653,6685079,0.754189566607295
2824,Italy,ITA,2010,8939513,3515055,629203,2614116,6758374,0.7560114292579473
2825,Italy,ITA,2012,9028362,3568456,633371,2636535,6838362,0.7574310821830139
2826,Italy,ITA,2006,8550563,3133647,614747,2629638,6378032,0.7459195376959389
2827,Italy,ITA,2014,9071709,3595539,635325,2646580,6877444,0.7581199970148954
2828,Italy,ITA,2015,9076941,3599096,635405,2649872,6884373,0.7584463752711403
2829,Italy,ITA,2016,9067763,3591225,635001,2650684,6876910,0.7583910166156747
2830,Italy,ITA,2017,9056491,3581587,634421,2652010,6868018,0.7583530972426297
2831,Italy,ITA,2018,9056173,3579008,633649,2664098,6876755,0.7593444824872493
2832,Italy,ITA,2013,9055645,3585177,634658,2642813,6862648,0.7578309441238035
2833,Italy,ITA,2005,8482501,3079004,610850,2630579,6320433,0.7451143241833983
2834,Italy,ITA,2019,9065825,3580037,632675,2687097,6899809,0.7610789972230878
2835,Italy,ITA,2003,8392485,3033938,597285,2634208,6265431,0.7465525407552114
2836,Italy,ITA,1990,8863928,3656773,572070,2506729,6735572,0.7598856849920261
2837,Italy,ITA,1991,8786779,3542252,573865,2553358,6669475,0.7590352505736174
2838,Italy,ITA,1992,8708754,3433395,575252,2592981,6601628,0.7580450659187296
2839,Italy,ITA,1993,8634790,3335215,576285,2624852,6536352,0.7569786873797741
2840,Italy,ITA,1994,8567480,3252141,577012,2647340,6476493,0.7559390859389226
2841,Italy,ITA,1995,8509581,3188773,577321,2658298,6424392,0.7549598505496334
2842,Italy,ITA,2004,8433982,3054967,605020,2628710,6288697,0.74563794421188
2843,Italy,ITA,1997,8404250,3082289,577767,2660431,6320487,0.7520584228217866
2844,Italy,ITA,1998,8360480,3037725,578444,2658348,6274517,0.7504972202552963
2845,Italy,ITA,1999,8333339,3008062,579446,2656795,6244303,0.7493158504652216
2846,Italy,ITA,2000,8330737,3000137,580772,2656973,6237882,0.7487791296256262
2847,Italy,ITA,2001,8344627,3007352,583974,2654128,6245454,0.7484401639522054
2848,Italy,ITA,2002,8364473,3018472,589881,2644843,6253196,0.7475899557569258
2849,Italy,ITA,1996,8456107,3135085,577423,2660802,6373310,0.7536931592753024
2850,Jamaica,JAM,2007,370223,109611,26203,79067,214881,0.5804096449977446
2851,Jamaica,JAM,2009,374166,112363,26713,79624,218700,0.5844999278395151
2852,Jamaica,JAM,2010,376110,113516,26964,80207,220687,0.5867618515859722
2853,Jamaica,JAM,2011,378286,114629,27211,81254,223094,0.5897495545698228
2854,Jamaica,JAM,2012,380793,115847,27456,82667,225970,0.5934195218924717
2855,Jamaica,JAM,2015,387603,119028,28153,86770,233951,0.6035840795865873
2856,Jamaica,JAM,2014,385867,118181,27935,85624,231740,0.6005696263220228
2857,Jamaica,JAM,2006,367761,108185,25927,78660,212772,0.5785605325197615
2858,Jamaica,JAM,2016,388766,119444,28352,87588,235384,0.6054644696295458
2859,Jamaica,JAM,2017,389695,119813,28538,88409,236760,0.6075520599443154
2860,Jamaica,JAM,2018,391773,120450,28713,90243,239406,0.6110834590438851
2861,Jamaica,JAM,2019,394754,121201,28879,93124,243204,0.616090020620437
2862,Jamaica,JAM,2013,383484,117082,27701,84205,228988,0.5971253037936394
2863,Jamaica,JAM,2005,364847,106901,25637,77909,210447,0.5768089089399118
2864,Jamaica,JAM,2008,372350,111039,26464,79327,216830,0.5823284544111723
2865,Jamaica,JAM,2003,358215,104527,25032,75826,205385,0.5733567829376213
2866,Jamaica,JAM,1990,307971,87287,20615,62986,170888,0.5548834143474548
2867,Jamaica,JAM,1991,309732,88134,20861,63070,172065,0.5555286505753361
2868,Jamaica,JAM,1992,312303,89175,21153,63381,173709,0.5562194407354396
2869,Jamaica,JAM,1993,315255,90356,21474,63875,175705,0.5573424687951024
2870,Jamaica,JAM,1994,318877,91651,21818,64577,178046,0.5583532208343656
2871,Jamaica,JAM,1995,322917,93046,22179,65586,180811,0.5599302607171502
2872,Jamaica,JAM,2004,361730,105728,25338,76963,208029,0.5750946838802422
2873,Jamaica,JAM,1997,332157,96065,22935,68135,187135,0.5633932146545158
2874,Jamaica,JAM,1998,336959,97619,23316,69549,190484,0.5653031971248728
2875,Jamaica,JAM,1999,341666,99146,23690,70910,193746,0.5670625698781852
2876,Jamaica,JAM,2000,346183,100608,24053,72167,196828,0.5685663363018981
2877,Jamaica,JAM,2001,350395,101985,24397,73362,199744,0.5700537964297435
2878,Jamaica,JAM,2002,354482,103281,24721,74599,202601,0.5715410091344554
2879,Jamaica,JAM,1996,327443,94529,22553,66795,183877,0.5615542247047578
2880,Japan,JPN,2006,13699295,3630188,988261,3495170,8113619,0.5922654413968018
2881,Japan,JPN,2007,13603427,3580381,980554,3462931,8023866,0.5898415156710144
2882,Japan,JPN,2008,13486426,3518344,971721,3421006,7911071,0.5865950697390102
2883,Japan,JPN,2009,13374060,3457246,964245,3382171,7803662,0.583492372548052
2884,Japan,JPN,2010,13292205,3409300,960141,3358800,7728241,0.5814115114836101
2885,Japan,JPN,2011,13221258,3364982,957945,3340625,7663552,0.5796386395303684
2886,Japan,JPN,2015,12887752,3176966,945975,3257460,7380401,0.5726678322177522
2887,Japan,JPN,2013,13038217,3257810,952005,3287489,7497304,0.5750252507685675
2888,Japan,JPN,2014,12953359,3210363,948948,3266722,7426033,0.5732901404184042
2889,Japan,JPN,2016,12836080,3153083,942807,3258095,7353985,0.572915173479754
2890,Japan,JPN,2017,12785986,3135317,938709,3259497,7333523,0.5735594423457057
2891,Japan,JPN,2018,12732397,3124529,934415,3258680,7317624,0.5747247749186583
2892,Japan,JPN,2005,13743144,3653143,992170,3504905,8150218,0.5930388272145005
2893,Japan,JPN,2012,13131352,3311753,955001,3314315,7581069,0.5773258534231662
2894,Japan,JPN,2019,12670645,3116121,929870,3256955,7302946,0.5763673435724859
2895,Japan,JPN,2004,13742682,3657632,989946,3489219,8136797,0.5920821714422265
2896,Japan,JPN,2002,13697366,3664082,974315,3419930,8058327,0.5883121616228989
2897,Japan,JPN,1990,13227868,3588413,919666,2940698,7448777,0.5631124380739209
2898,Japan,JPN,1991,13217404,3601888,926861,2904031,7432780,0.5623479466921039
2899,Japan,JPN,1992,13214896,3613275,933588,2884690,7431553,0.5623618225977715
2900,Japan,JPN,1993,13223963,3623860,939919,2881351,7445130,0.5630029364117247
2901,Japan,JPN,1994,13240125,3633126,945597,2889417,7468140,0.5640535871073725
2902,Japan,JPN,1995,13259650,3640452,950140,2904955,7495547,0.5652899586339006
2903,Japan,JPN,2003,13725872,3661331,982958,3459453,8103742,0.5903990653562848
2904,Japan,JPN,1997,13389484,3653438,956918,3045191,7655547,0.571758179777503
2905,Japan,JPN,1998,13486785,3659219,959596,3155863,7774678,0.5764663705990716
2906,Japan,JPN,1999,13575306,3663530,961742,3259593,7884865,0.5808241081269181
2907,Japan,JPN,2000,13630358,3665688,963075,3329957,7958720,0.5838966225245148
2908,Japan,JPN,2001,13664085,3665772,966840,3375312,8007924,0.5860563660135311
2909,Japan,JPN,1996,13306367,3647193,953866,2953711,7554770,0.5677560223613253
2910,Jordan,JOR,2006,849558,288846,44197,226122,559165,0.6581834318551529
2911,Jordan,JOR,2007,881430,301618,46153,233588,581359,0.6595634366881091
2912,Jordan,JOR,2008,915988,315846,48296,241478,605620,0.6611658668017485
2913,Jordan,JOR,2009,957546,332413,50788,251325,634526,0.6626585041345272
2914,Jordan,JOR,2010,1001833,349387,53339,263050,665776,0.6645578654326619
2915,Jordan,JOR,2011,1057534,370009,56444,278477,704930,0.6665790414303464
2916,Jordan,JOR,2014,1282330,453634,69077,341082,863793,0.6736120967301709
2917,Jordan,JOR,2013,1212304,427570,65140,321027,813737,0.6712318032440708
2918,Jordan,JOR,2015,1354503,480027,73202,361824,915053,0.6755636569280393
2919,Jordan,JOR,2016,1425247,505474,77416,381523,964413,0.6766637642457763
2920,Jordan,JOR,2017,1496536,530848,81702,401963,1014513,0.6779075144199672
2921,Jordan,JOR,2005,802763,271742,41448,213919,527109,0.6566184540144476
2922,Jordan,JOR,2019,1655015,585785,90280,457274,1133339,0.6847907722890729
2923,Jordan,JOR,2012,1134572,398677,60785,299558,759020,0.6689923601146511
2924,Jordan,JOR,2018,1573281,557593,85981,426911,1070485,0.680415640943989
2925,Jordan,JOR,2004,743777,250931,38046,198159,487136,0.6549489968095276
2926,Jordan,JOR,2002,689489,231363,34843,182820,449026,0.6512446173905603
2927,Jordan,JOR,2003,706390,237618,35872,187906,461396,0.653174591939297
2928,Jordan,JOR,1990,510087,169851,24568,130286,324705,0.6365678795970099
2929,Jordan,JOR,1991,532863,177340,25755,136469,339564,0.637244469966952
2930,Jordan,JOR,1992,554615,184462,26895,142337,353694,0.6377288749853502
2931,Jordan,JOR,1994,592233,196971,28947,152957,378875,0.6397397645858978
2932,Jordan,JOR,1995,607363,202044,29811,157567,389422,0.6411684610356574
2933,Jordan,JOR,1993,574369,191062,27967,147868,366897,0.6387827337478171
2934,Jordan,JOR,1997,631206,210357,31261,164935,406553,0.6440892513696004
2935,Jordan,JOR,1998,641679,214159,31925,168101,414185,0.6454707104330981
2936,Jordan,JOR,1999,652496,218005,32589,171352,421946,0.6466645006252912
2937,Jordan,JOR,2000,663527,221926,33259,174730,429915,0.6479238975957271
2938,Jordan,JOR,2001,675659,226215,33984,178562,438761,0.6493823067553307
2939,Jordan,JOR,1996,619979,206422,30572,161480,398474,0.6427217696083254
2940,Kazakhstan,KAZ,2011,1670038,355897,89084,579477,1024458,0.6134339458144066
2941,Kazakhstan,KAZ,2007,1625029,342587,84435,555228,982250,0.6044507513404376
2942,Kazakhstan,KAZ,2008,1633640,345761,85640,560018,991419,0.6068772801841287
2943,Kazakhstan,KAZ,2009,1643447,349068,86860,565251,1001179,0.6091945770079595
2944,Kazakhstan,KAZ,2010,1655253,352384,88003,571365,1011752,0.6112370737283062
2945,Kazakhstan,KAZ,2012,1686592,359283,90022,588670,1037975,0.615427441847228
2946,Kazakhstan,KAZ,2006,1616271,339522,83253,550515,973290,0.6021824310403392
2947,Kazakhstan,KAZ,2014,1723888,366550,91787,607898,1066235,0.6185059586237621
2948,Kazakhstan,KAZ,2015,1744323,370612,92676,616094,1079382,0.618797092052332
2949,Kazakhstan,KAZ,2016,1765226,374569,93555,623511,1091635,0.6184109003606337
2950,Kazakhstan,KAZ,2017,1787300,378802,94430,630862,1104094,0.6177440832540704
2951,Kazakhstan,KAZ,2018,1810301,384099,95331,637130,1116560,0.6167814081746626
2952,Kazakhstan,KAZ,2013,1704259,362742,90891,598341,1051974,0.6172618129051981
2953,Kazakhstan,KAZ,2005,1607700,336541,82096,544918,963555,0.5993375629781675
2954,Kazakhstan,KAZ,2019,1833677,390347,96280,642565,1129192,0.6158074731809364
2955,Kazakhstan,KAZ,2003,1593759,331384,79948,533833,945165,0.5930413569429255
2956,Kazakhstan,KAZ,1990,1618630,337475,80648,529582,947705,0.5854982299846166
2957,Kazakhstan,KAZ,1991,1615577,336729,80461,526661,943851,0.5842191365685449
2958,Kazakhstan,KAZ,1992,1608752,335282,80095,523017,938394,0.5833055685400858
2959,Kazakhstan,KAZ,1993,1600011,333362,79584,519027,931973,0.5824791204560469
2960,Kazakhstan,KAZ,1994,1590523,331151,79009,515110,925270,0.5817394655720163
2961,Kazakhstan,KAZ,1995,1580954,328910,78428,511453,918791,0.5811623867614112
2962,Kazakhstan,KAZ,2004,1599882,333767,80977,539068,953812,0.5961764680145161
2963,Kazakhstan,KAZ,1997,1571654,325748,77531,510804,914083,0.5816057478299931
2964,Kazakhstan,KAZ,1998,1573157,325271,77365,513843,916479,0.5825731316073348
2965,Kazakhstan,KAZ,1999,1577077,325539,77456,517806,920801,0.5838655943875918
2966,Kazakhstan,KAZ,2000,1581757,326460,77804,521555,925819,0.5853105122974009
2967,Kazakhstan,KAZ,2001,1585471,327741,78341,524936,931018,0.5872185615504794
2968,Kazakhstan,KAZ,2002,1589147,329387,79064,529065,937516,0.5899491991615627
2969,Kazakhstan,KAZ,1996,1573946,326979,77902,509757,914638,0.581111423136499
2970,Kenya,KEN,2007,3917504,1097538,184179,1298419,2580136,0.6586173236836517
2971,Kenya,KEN,2008,4023035,1131780,189931,1328462,2650173,0.658749675307324
2972,Kenya,KEN,2009,4132519,1167373,195917,1360408,2723698,0.6590890447206655
2973,Kenya,KEN,2010,4248339,1204273,202163,1396805,2803241,0.6598440002080813
2974,Kenya,KEN,2011,4368401,1243027,208654,1436158,2887839,0.6610746128846687
2975,Kenya,KEN,2012,4489490,1284012,215391,1475948,2975351,0.6627369701235553
2976,Kenya,KEN,2015,4869630,1413708,237029,1609888,3260625,0.6695837260736442
2977,Kenya,KEN,2014,4738338,1370013,229569,1561384,3160966,0.6671043728834878
2978,Kenya,KEN,2016,5006570,1460064,244723,1662801,3367588,0.6726337592403582
2979,Kenya,KEN,2017,5147245,1506917,252639,1719367,3478923,0.675880592433428
2980,Kenya,KEN,2018,5290588,1550751,260739,1780044,3591534,0.6788534658151419
2981,Kenya,KEN,2006,3813893,1064695,178640,1268421,2511756,0.6585806156596422
2982,Kenya,KEN,2013,4612088,1326569,222363,1517245,3066177,0.6648132039111135
2983,Kenya,KEN,2005,3710872,1033331,173302,1236653,2443286,0.6584129013342417
2984,Kenya,KEN,2019,5436049,1592803,268996,1844799,3706598,0.6818551488406378
2985,Kenya,KEN,2003,3508989,973974,163069,1172714,2309757,0.6582400229809783
2986,Kenya,KEN,1990,2288863,634359,104069,737435,1475863,0.6448018077097668
2987,Kenya,KEN,1991,2370595,657529,107970,763186,1528685,0.6448528744893159
2988,Kenya,KEN,1992,2455203,681424,112013,790429,1583866,0.6451059240315363
2989,Kenya,KEN,1993,2542122,705948,116188,819124,1641260,0.6456259770380808
2990,Kenya,KEN,1994,2630960,731039,120486,848996,1700521,0.6463500015203576
2991,Kenya,KEN,1995,2721384,756648,124902,879876,1761426,0.6472537502976426
2992,Kenya,KEN,2004,3608618,1003197,168127,1204303,2375627,0.6583204428953134
2993,Kenya,KEN,1997,2914203,808930,134037,953573,1896540,0.650792000420012
2994,Kenya,KEN,1998,3015419,835501,138722,995045,1969268,0.6530661244755704
2995,Kenya,KEN,1999,3116674,862400,143476,1035996,2041872,0.6551445547400851
2996,Kenya,KEN,2000,3215649,889660,148288,1073686,2111634,0.6566742825476288
2997,Kenya,KEN,2001,3312948,917306,153158,1107992,2178456,0.6575581626998069
2998,Kenya,KEN,2002,3410476,945399,158086,1140755,2244240,0.6580430414991925
2999,Kenya,KEN,1996,2815550,782637,129426,914464,1826527,0.6487283124078776
3000,Kiribati,KIR,2006,11023,3650,221,2464,6335,0.5747074299192597
3001,Kiribati,KIR,2007,11277,3743,227,2524,6494,0.5758623747450563
3002,Kiribati,KIR,2008,11534,3835,233,2586,6654,0.5769030691867522
3003,Kiribati,KIR,2009,11775,3924,239,2644,6807,0.5780891719745223
3004,Kiribati,KIR,2010,11999,4003,244,2702,6949,0.579131594299525
3005,Kiribati,KIR,2011,12194,4075,248,2752,7075,0.5802033787108414
3006,Kiribati,KIR,2015,12893,4340,264,2930,7534,0.5843480958659738
3007,Kiribati,KIR,2013,12556,4213,256,2845,7314,0.5825103536158012
3008,Kiribati,KIR,2014,12725,4278,260,2889,7427,0.5836542239685658
3009,Kiribati,KIR,2016,13043,4391,267,2972,7630,0.5849881162309285
3010,Kiribati,KIR,2017,13204,4444,271,3018,7733,0.5856558618600424
3011,Kiribati,KIR,2018,13383,4514,275,3064,7853,0.5867892101920347
3012,Kiribati,KIR,2005,10775,3562,215,2402,6179,0.5734570765661253
3013,Kiribati,KIR,2012,12379,4145,253,2801,7199,0.5815493981743275
3014,Kiribati,KIR,2019,13585,4598,279,3113,7990,0.5881486934118513
3015,Kiribati,KIR,2004,10542,3482,209,2344,6035,0.5724720166951243
3016,Kiribati,KIR,2002,10113,3338,199,2239,5776,0.5711460496390784
3017,Kiribati,KIR,2003,10324,3408,204,2289,5901,0.5715807826423867
3018,Kiribati,KIR,1990,8109,2656,162,1903,4721,0.5821926254778641
3019,Kiribati,KIR,1991,8264,2703,164,1929,4796,0.5803484995159729
3020,Kiribati,KIR,1992,8404,2746,166,1948,4860,0.5782960495002379
3021,Kiribati,KIR,1994,8669,2830,170,1979,4979,0.5743453685546199
3022,Kiribati,KIR,1995,8808,2877,172,1998,5047,0.5730018165304269
3023,Kiribati,KIR,1993,8538,2787,168,1964,4919,0.5761302412743031
3024,Kiribati,KIR,1997,9131,2992,178,2048,5218,0.5714598620085424
3025,Kiribati,KIR,1998,9313,3058,181,2077,5316,0.5708149897992054
3026,Kiribati,KIR,1999,9505,3127,185,2109,5421,0.5703314045239348
3027,Kiribati,KIR,2000,9703,3198,189,2148,5535,0.5704421312995981
3028,Kiribati,KIR,2001,9908,3268,194,2192,5654,0.5706499798142914
3029,Kiribati,KIR,1996,8966,2932,174,2022,5128,0.5719384340843185
3030,Kuwait,KWT,2011,430589,146319,28719,135848,310886,0.7220017232209833
3031,Kuwait,KWT,2007,344634,115196,22633,107898,245727,0.7130085830185066
3032,Kuwait,KWT,2008,362622,121737,23937,113585,259259,0.7149566214956622
3033,Kuwait,KWT,2009,382967,129147,25408,120104,274659,0.7171871205613016
3034,Kuwait,KWT,2010,405998,137419,27040,127673,292132,0.7195404903472431
3035,Kuwait,KWT,2012,455905,155786,30416,144279,330481,0.7248900538489378
3036,Kuwait,KWT,2006,326118,108584,21310,102004,231898,0.7110861712631624
3037,Kuwait,KWT,2014,507295,175136,33789,161463,370388,0.7301234981618191
3038,Kuwait,KWT,2015,532540,184329,35466,170114,389909,0.7321684756074661
3039,Kuwait,KWT,2016,556734,192668,37112,178583,408363,0.7334975050921985
3040,Kuwait,KWT,2017,580623,200835,38744,187097,426676,0.7348589360049465
3041,Kuwait,KWT,2018,605708,209735,40350,196281,446366,0.7369326474142657
3042,Kuwait,KWT,2013,481619,165484,32101,152825,350410,0.7275668111100269
3043,Kuwait,KWT,2005,307354,102066,20007,95924,217997,0.7092700924666671
3044,Kuwait,KWT,2019,631554,219347,41947,205939,467233,0.7398148060181711
3045,Kuwait,KWT,2003,276959,91673,17914,85859,195446,0.7056856791077379
3046,Kuwait,KWT,1990,225805,75833,14175,65404,155412,0.6882575673700759
3047,Kuwait,KWT,1991,222816,74714,14058,65064,153836,0.6904172052276317
3048,Kuwait,KWT,1992,219336,73414,13888,64493,151795,0.6920660539081591
3049,Kuwait,KWT,1993,215745,72076,13696,63824,149596,0.6933926626341282
3050,Kuwait,KWT,1994,212465,70840,13506,63200,147546,0.6944484973995717
3051,Kuwait,KWT,1995,215686,71796,13744,64424,149964,0.6952885212762998
3052,Kuwait,KWT,2004,290855,96416,18869,90476,205761,0.7074349761908855
3053,Kuwait,KWT,1997,233447,77459,14960,70392,162811,0.6974216845793691
3054,Kuwait,KWT,1998,238059,78849,15266,72186,166301,0.6985705224335144
3055,Kuwait,KWT,1999,243888,80680,15654,74341,170675,0.6998089286885784
3056,Kuwait,KWT,2000,251046,82963,16136,76858,175957,0.7008954534228786
3057,Kuwait,KWT,2001,258472,85400,16641,79465,181506,0.7022269336717324
3058,Kuwait,KWT,2002,266361,88045,17182,82232,187459,0.7037779554814706
3059,Kuwait,KWT,1996,225791,75052,14440,67715,157207,0.6962500719692105
3060,Kyrgyzstan,KGZ,2007,584592,109484,27099,168259,304842,0.5214611216027588
3061,Kyrgyzstan,KGZ,2009,593927,112250,28107,172430,312787,0.5266421630941176
3062,Kyrgyzstan,KGZ,2010,599507,113720,28621,175117,317458,0.5295317652671279
3063,Kyrgyzstan,KGZ,2011,606140,115258,29119,178213,322590,0.5322037813046491
3064,Kyrgyzstan,KGZ,2012,612977,116868,29594,181290,327752,0.5346889034988263
3065,Kyrgyzstan,KGZ,2015,636349,122150,30990,190813,343953,0.5405100031586441
3066,Kyrgyzstan,KGZ,2014,628064,120341,30527,187550,338418,0.5388272532735517
3067,Kyrgyzstan,KGZ,2006,579890,108113,26605,166312,301030,0.519115694355826
3068,Kyrgyzstan,KGZ,2016,644781,123916,31446,193577,348939,0.5411744452767684
3069,Kyrgyzstan,KGZ,2017,653744,125768,31895,196321,353984,0.5414718911378155
3070,Kyrgyzstan,KGZ,2018,663768,127863,32347,199442,359652,0.5418338937701125
3071,Kyrgyzstan,KGZ,2019,674504,130177,32819,202782,365778,0.5422918173947078
3072,Kyrgyzstan,KGZ,2013,620319,118563,30059,184432,333054,0.5369076233357353
3073,Kyrgyzstan,KGZ,2005,574004,106679,26109,164088,296876,0.5172019707179741
3074,Kyrgyzstan,KGZ,2008,588995,110840,27597,170249,308686,0.5240893386191733
3075,Kyrgyzstan,KGZ,2003,560653,103698,25134,159565,288397,0.5143948217524922
3076,Kyrgyzstan,KGZ,1990,446643,84338,20361,135565,240264,0.5379329800310315
3077,Kyrgyzstan,KGZ,1991,455108,85732,20686,137437,243855,0.535817871801858
3078,Kyrgyzstan,KGZ,1992,463728,87136,21014,139154,247304,0.5332953800503744
3079,Kyrgyzstan,KGZ,1993,472468,88536,21329,140921,250786,0.5307999695217454
3080,Kyrgyzstan,KGZ,1994,481093,89909,21638,142449,253996,0.5279561332216433
3081,Kyrgyzstan,KGZ,1995,489983,91300,21952,144048,257300,0.5251202592743014
3082,Kyrgyzstan,KGZ,2004,567360,105186,25613,161756,292555,0.5156426254935138
3083,Kyrgyzstan,KGZ,1997,510195,94329,22636,147411,264376,0.5181861837140701
3084,Kyrgyzstan,KGZ,1998,520962,95949,23002,149250,268201,0.5148187391786733
3085,Kyrgyzstan,KGZ,1999,531002,97573,23393,151153,272119,0.5124632298936728
3086,Kyrgyzstan,KGZ,2000,539658,99162,23806,153208,276176,0.5117611524335783
3087,Kyrgyzstan,KGZ,2001,546972,100689,24229,155348,280266,0.5123955156753911
3088,Kyrgyzstan,KGZ,2002,553744,102200,24676,157370,284246,0.513316622843769
3089,Kyrgyzstan,KGZ,1996,499574,92763,22280,145712,260755,0.5219547054090085
3090,Laos,LAO,2006,675442,230140,16565,135233,381938,0.5654638000005922
3091,Laos,LAO,2007,686596,237229,17026,137642,391897,0.5707825271338604
3092,Laos,LAO,2008,697053,244534,17477,139853,401864,0.5765185717585319
3093,Laos,LAO,2009,706959,251763,17929,142288,411980,0.5827494946665931
3094,Laos,LAO,2010,716940,258476,18381,145408,422265,0.5889823416185455
3095,Laos,LAO,2011,727092,264957,18834,149593,433384,0.5960511187029977
3096,Laos,LAO,2015,768864,291154,20618,168695,480467,0.6249050547300953
3097,Laos,LAO,2013,748142,278440,19732,159404,457576,0.6116165113040037
3098,Laos,LAO,2014,758509,285010,20177,164349,469536,0.6190249555377721
3099,Laos,LAO,2016,778678,297024,21057,172096,490177,0.6294989713334652
3100,Laos,LAO,2017,788742,302714,21493,175488,499695,0.6335341594589866
3101,Laos,LAO,2018,799643,309047,21924,179092,510063,0.6378633965407063
3102,Laos,LAO,2005,663494,223739,16099,132195,372033,0.5607179567562027
3103,Laos,LAO,2012,737324,271683,19284,154290,445257,0.603882418041458
3104,Laos,LAO,2019,811704,316371,22350,182924,521645,0.6426542187792594
3105,Laos,LAO,2004,651195,218119,15660,128685,362464,0.5566136103624875
3106,Laos,LAO,2002,626437,207472,14847,121686,344005,0.5491454048850882
3107,Laos,LAO,1990,476788,148592,10647,93067,252306,0.5291785867093971
3108,Laos,LAO,1991,490405,153393,10962,95948,260303,0.5307918964937144
3109,Laos,LAO,1992,504215,158305,11288,98830,268423,0.532358220203683
3110,Laos,LAO,1993,517311,163057,11606,101530,276193,0.5339012702223614
3111,Laos,LAO,1994,529743,167643,11918,104215,283776,0.5356861723514987
3112,Laos,LAO,1995,542558,172319,12244,106979,291542,0.5373471591977264
3113,Laos,LAO,2003,639078,212783,15250,125141,353174,0.5526305083260572
3114,Laos,LAO,1997,566593,181872,12934,110654,305460,0.5391171440522562
3115,Laos,LAO,1998,577544,186769,13296,111713,311778,0.5398341944509856
3116,Laos,LAO,1999,588706,191779,13670,113079,318528,0.541064640075012
3117,Laos,LAO,2000,600598,196891,14052,115262,326205,0.5431336767688204
3118,Laos,LAO,2001,613291,202140,14445,118257,334842,0.5459757276725078
3119,Laos,LAO,1996,554992,177084,12585,109195,298864,0.5385014558768415
3120,Latin America & Caribbean (WB),,2006,80843541,33291371,5540989,19674484,58506844,0.7237046185297599
3121,Latin America & Caribbean (WB),,2007,81678877,33676335,5636800,19764449,59077584,0.7232908454409822
3122,Latin America & Caribbean (WB),,2008,82384419,33996319,5731659,19777114,59505092,0.7222857516298076
3123,Latin America & Caribbean (WB),,2009,83119132,34334150,5825437,19820169,59979756,0.7216119148116225
3124,Latin America & Caribbean (WB),,2010,84045833,34770612,5917418,20003423,60691453,0.7221232848034239
3125,Latin America & Caribbean (WB),,2011,84946702,35031833,6008167,20305916,61345916,0.722169484578695
3126,Latin America & Caribbean (WB),,2014,86748859,34557544,6277430,21278459,62113433,0.716014408904214
3127,Latin America & Caribbean (WB),,2013,86134786,34697562,6189449,20951730,61838741,0.7179299313520091
3128,Latin America & Caribbean (WB),,2015,87613723,34767483,6361950,21599257,62728690,0.7159687758046762
3129,Latin America & Caribbean (WB),,2016,88803570,35408580,6439561,21897057,63745198,0.717822470425457
3130,Latin America & Caribbean (WB),,2017,89958471,36053877,6512655,22198168,64764700,0.7199399820835105
3131,Latin America & Caribbean (WB),,2005,79718788,32761590,5444539,19412299,57618428,0.7227709984752905
3132,Latin America & Caribbean (WB),,2019,92003844,37009182,6656730,22856887,66522799,0.7230436915222803
3133,Latin America & Caribbean (WB),,2012,85587970,34933071,6099083,20624691,61656845,0.720391487261586
3134,Latin America & Caribbean (WB),,2018,90978253,36533120,6584977,22524492,65642589,0.7215195591852044
3135,Latin America & Caribbean (WB),,2004,78253944,31973427,5344027,19017461,56334915,0.7198987312383898
3136,Latin America & Caribbean (WB),,2002,74744180,29800198,5132485,18168633,53101316,0.710440812916805
3137,Latin America & Caribbean (WB),,2003,76560405,30948344,5238907,18599112,54786363,0.7155965671811689
3138,Latin America & Caribbean (WB),,1990,55622693,19468444,3965418,12969623,36403485,0.6544718178244264
3139,Latin America & Caribbean (WB),,1991,56792499,19992788,4057958,13271125,37321871,0.6571619783802787
3140,Latin America & Caribbean (WB),,1992,58008002,20535627,4152890,13591585,38280102,0.6599107136977412
3141,Latin America & Caribbean (WB),,1994,60508290,21615937,4346770,14278712,40241419,0.665056292286561
3142,Latin America & Caribbean (WB),,1995,61764775,22125241,4444644,14639427,41209312,0.6671976381359763
3143,Latin America & Caribbean (WB),,1993,59251746,21081539,4249359,13927425,39258323,0.6625682051631019
3144,Latin America & Caribbean (WB),,1997,65136797,23883011,4639540,15629151,44151702,0.6778304128156624
3145,Latin America & Caribbean (WB),,1998,67205598,25130020,4736313,16229614,46095947,0.6858944548041965
3146,Latin America & Caribbean (WB),,1999,69276830,26411862,4832354,16811832,48056048,0.6936813939090458
3147,Latin America & Caribbean (WB),,2000,71145638,27553585,4928406,17304219,49786210,0.6997788114571409
3148,Latin America & Caribbean (WB),,2001,72908881,28635412,5027965,17733812,51397189,0.7049510059000905
3149,Latin America & Caribbean (WB),,1996,63262757,22832718,4542177,15079483,42454378,0.6710801111624016
3150,Latvia,LVA,2011,274075,88642,12605,101285,202532,0.7389656116026635
3151,Latvia,LVA,2007,293620,93611,13349,108151,215111,0.7326169879436005
3152,Latvia,LVA,2008,288385,92515,13192,106084,211791,0.7344036617715901
3153,Latvia,LVA,2009,283296,91315,13011,104169,208495,0.7359616796566136
3154,Latvia,LVA,2010,278514,89995,12812,102600,205407,0.7375105021650618
3155,Latvia,LVA,2012,269942,87372,12398,100025,199795,0.740140474620474
3156,Latvia,LVA,2006,298816,94666,13488,110207,218361,0.7307540426215464
3157,Latvia,LVA,2014,262808,85082,12006,97728,194816,0.7412864144166084
3158,Latvia,LVA,2015,259644,84034,11830,96724,192588,0.7417386883579055
3159,Latvia,LVA,2016,256852,82839,11669,95980,190488,0.7416255275411521
3160,Latvia,LVA,2017,254183,81671,11512,95283,188466,0.7414579259824614
3161,Latvia,LVA,2018,251885,80721,11360,94767,186848,0.7417988367707485
3162,Latvia,LVA,2013,266256,86191,12198,98845,197234,0.7407682831560604
3163,Latvia,LVA,2005,303403,95659,13604,111912,221175,0.7289809263586715
3164,Latvia,LVA,2019,249853,79833,11214,94417,185464,0.742292467971167
3165,Latvia,LVA,2003,312434,97429,13779,115375,226583,0.7252187662034222
3166,Latvia,LVA,1990,349661,106028,15090,133613,254731,0.728508469632015
3167,Latvia,LVA,1991,349283,105853,15043,132921,253817,0.7266800846305145
3168,Latvia,LVA,1992,348294,105535,14968,132034,252537,0.7250684766318111
3169,Latvia,LVA,1993,346458,105009,14858,130831,250698,0.7236028609528428
3170,Latvia,LVA,1994,343577,104239,14714,129242,248195,0.7223853750396563
3171,Latvia,LVA,1995,340370,103360,14564,127715,245639,0.7216822869230544
3172,Latvia,LVA,2004,307816,96571,13698,113525,223794,0.7270382306312863
3173,Latvia,LVA,1997,334118,101886,14315,124651,240852,0.7208590976840518
3174,Latvia,LVA,1998,330905,101162,14202,123107,238471,0.7206630301748236
3175,Latvia,LVA,1999,327529,100418,14099,121569,236086,0.7208094550406223
3176,Latvia,LVA,2000,324502,99719,14013,120369,234101,0.7214162008246482
3177,Latvia,LVA,2001,321110,98997,13933,119040,231970,0.7224004235308773
3178,Latvia,LVA,2002,316957,98225,13856,117274,229355,0.7236155062043116
3179,Latvia,LVA,1996,337169,102575,14431,126174,243180,0.7212406834554779
3180,Lebanon,LBN,2007,645620,246860,38338,202336,487534,0.7551407948948298
3181,Lebanon,LBN,2009,669132,268096,39322,207367,514785,0.769332508383996
3182,Lebanon,LBN,2010,680358,274803,40013,210819,525635,0.7725859033038489
3183,Lebanon,LBN,2011,709611,286612,41972,220299,548883,0.7734984378765267
3184,Lebanon,LBN,2012,759812,306861,45256,235580,587697,0.7734768600653846
3185,Lebanon,LBN,2013,797339,321465,47705,247582,616752,0.7735128972745595
3186,Lebanon,LBN,2016,815921,326311,48749,255764,630824,0.773143478351458
3187,Lebanon,LBN,2015,810950,325044,48493,253984,627521,0.7738097293297984
3188,Lebanon,LBN,2006,631869,235858,37671,199066,472595,0.7479319289283063
3189,Lebanon,LBN,2017,820530,327780,49045,256665,633490,0.7720497727078839
3190,Lebanon,LBN,2018,818750,324348,49439,254166,627953,0.7669654961832061
3191,Lebanon,LBN,2019,807971,314425,49920,247505,611850,0.7572672781572606
3192,Lebanon,LBN,2014,807502,324563,48336,251901,624800,0.7737442136366226
3193,Lebanon,LBN,2005,619696,228742,36900,195006,460648,0.7433451240608299
3194,Lebanon,LBN,2008,658467,258494,38869,204955,502318,0.7628597940367551
3195,Lebanon,LBN,2003,600811,221233,35397,186304,442934,0.7372268483766109
3196,Lebanon,LBN,2004,609912,224803,36114,190631,451548,0.7403494274583874
3197,Lebanon,LBN,1991,492424,188234,28201,130322,346757,0.7041837928289442
3198,Lebanon,LBN,1992,502479,191400,28691,134822,354913,0.7063240453829911
3199,Lebanon,LBN,1993,512691,194632,29228,139410,363270,0.7085554456778059
3200,Lebanon,LBN,1994,523283,198121,29819,144078,372018,0.7109307965288382
3201,Lebanon,LBN,1995,533809,201701,30423,148629,380753,0.7132757222152493
3202,Lebanon,LBN,1996,543472,204482,31020,153314,388816,0.7154296817499337
3203,Lebanon,LBN,1990,481833,184895,27687,125890,338472,0.7024674524160861
3204,Lebanon,LBN,1998,559799,207443,32224,163810,403477,0.7207533418244763
3205,Lebanon,LBN,1999,567632,208998,32860,169084,410942,0.7239584801420639
3206,Lebanon,LBN,2000,575518,211429,33476,173714,418619,0.7273777709819675
3207,Lebanon,LBN,2001,583289,214470,34067,177699,426236,0.7307458223967879
3208,Lebanon,LBN,2002,591727,217759,34709,181942,434410,0.7341392229862758
3209,Lebanon,LBN,1997,551916,206175,31612,158439,396226,0.717909971807304
3210,Lesotho,LSO,2007,230536,65032,9584,87395,162011,0.7027579206718256
3211,Lesotho,LSO,2019,257120,73516,10913,103288,187717,0.7300754511512134
3212,Lesotho,LSO,2009,233151,65778,9739,89387,164904,0.7072841205913764
3213,Lesotho,LSO,2010,234926,66358,9840,90503,166701,0.7095894026203996
3214,Lesotho,LSO,2011,237039,67110,9949,91759,168818,0.712195039634828
3215,Lesotho,LSO,2012,239436,68017,10061,93103,171181,0.7149342621827962
3216,Lesotho,LSO,2015,246565,70874,10394,96981,178249,0.7229290450793908
3217,Lesotho,LSO,2014,244127,69962,10281,95676,175919,0.7206044394925591
3218,Lesotho,LSO,2016,248977,71840,10513,98257,180610,0.7254083710543544
3219,Lesotho,LSO,2017,251638,72765,10642,99649,183056,0.7274576971681542
3220,Lesotho,LSO,2018,254356,73326,10777,101305,185408,0.7289311044363018
3221,Lesotho,LSO,2006,230103,64902,9540,86749,161191,0.7005167251187512
3222,Lesotho,LSO,2013,241823,68990,10171,94426,173587,0.7178266748820418
3223,Lesotho,LSO,2005,230168,64908,9517,86299,160724,0.6982899447360189
3224,Lesotho,LSO,2008,231578,65329,9652,88279,163260,0.704989247683286
3225,Lesotho,LSO,2003,230828,65035,9486,85475,159996,0.6931394804789713
3226,Lesotho,LSO,1990,207967,56345,8039,75123,139507,0.6708131578567753
3227,Lesotho,LSO,1991,210360,57532,8191,74872,140595,0.6683542498573873
3228,Lesotho,LSO,1992,212770,58708,8347,74761,141816,0.6665225360718147
3229,Lesotho,LSO,1993,215256,59850,8505,74887,143242,0.6654495112795926
3230,Lesotho,LSO,1994,217821,60931,8663,75437,145031,0.6658265272861662
3231,Lesotho,LSO,1995,220568,61919,8816,76422,147157,0.667172935330601
3232,Lesotho,LSO,2004,230500,64972,9502,85930,160404,0.6958958785249457
3233,Lesotho,LSO,1997,225832,63531,9090,79320,151941,0.6728054482978497
3234,Lesotho,LSO,1998,227910,64115,9202,80835,154152,0.6763722522048177
3235,Lesotho,LSO,1999,229432,64543,9294,82144,155981,0.6798572125945814
3236,Lesotho,LSO,2000,230361,64820,9366,83259,157445,0.6834707263816358
3237,Lesotho,LSO,2001,230820,64977,9421,84121,158519,0.6867645784594056
3238,Lesotho,LSO,2002,230926,65045,9460,84851,159356,0.6900738764799114
3239,Lesotho,LSO,1996,223368,62794,8960,77825,149579,0.6696527703162494
3240,Liberia,LBR,2007,401950,110941,15678,128641,255260,0.6350541112078617
3241,Liberia,LBR,2009,433816,120055,17050,138904,276009,0.6362351780478359
3242,Liberia,LBR,2010,456268,126568,18033,146267,290868,0.6374937536710881
3243,Liberia,LBR,2011,467823,130296,18564,150714,299574,0.640357571132672
3244,Liberia,LBR,2012,474232,132912,18870,153678,305460,0.6441151166517654
3245,Liberia,LBR,2015,506899,144944,20384,166723,332051,0.6550634347276282
3246,Liberia,LBR,2014,495857,141045,19871,162381,323297,0.6519964425227435
3247,Liberia,LBR,2006,385168,106189,14953,123188,244330,0.6343465708470071
3248,Liberia,LBR,2016,518001,148607,20905,171229,340741,0.6577998884172038
3249,Liberia,LBR,2017,530637,152552,21490,176184,350226,0.66001051566325
3250,Liberia,LBR,2018,539773,156760,22136,176515,355411,0.6584453094171068
3251,Liberia,LBR,2019,543560,161051,22818,170534,354403,0.6520034586798146
3252,Liberia,LBR,2013,484286,136803,19343,157791,313937,0.6482471101786961
3253,Liberia,LBR,2005,366191,100706,14125,116974,231805,0.6330166497811252
3254,Liberia,LBR,2008,414925,114642,16238,132876,263756,0.6356715068988371
3255,Liberia,LBR,2003,337687,92629,12968,104524,210121,0.6222359759185281
3256,Liberia,LBR,1990,205986,59395,8226,65415,133036,0.6458497179419961
3257,Liberia,LBR,1991,219448,62644,8687,68395,139726,0.6367157595421239
3258,Liberia,LBR,1992,225142,63614,8820,69316,141750,0.6296026507715131
3259,Liberia,LBR,1993,226013,63269,8765,68993,141027,0.6239773818320186
3260,Liberia,LBR,1994,231706,64426,8934,70097,143457,0.61913372981278
3261,Liberia,LBR,1995,245439,68001,9452,73481,150934,0.6149552434617155
3262,Liberia,LBR,2004,349698,95956,13431,110605,219992,0.6290913874257216
3263,Liberia,LBR,1997,282034,77808,10877,82859,171544,0.608238722990845
3264,Liberia,LBR,1998,297680,81977,11485,86877,180339,0.6058149690943295
3265,Liberia,LBR,1999,314477,86511,12150,91273,189934,0.6039678577447636
3266,Liberia,LBR,2000,326940,89916,12643,94721,197280,0.6034134703615343
3267,Liberia,LBR,2001,332836,91493,12854,97525,201872,0.6065209292264058
3268,Liberia,LBR,2002,333329,91494,12828,100306,204628,0.6138919805957478
3269,Liberia,LBR,1996,265594,73423,10239,78658,162320,0.6111583846020618
3270,Libya,LBY,2006,832775,310299,45013,238591,593903,0.7131614181501607
3271,Libya,LBY,2007,850669,317086,46239,245870,609195,0.716136358560145
3272,Libya,LBY,2008,866849,323435,47373,252757,623565,0.7193467374363932
3273,Libya,LBY,2009,877751,327597,48160,258066,633823,0.7220988640286369
3274,Libya,LBY,2010,888861,331621,48921,263308,643850,0.724353976606016
3275,Libya,LBY,2011,911499,339664,50241,271432,661337,0.725548793800103
3276,Libya,LBY,2015,994707,367182,54520,299719,721421,0.7252598001220459
3277,Libya,LBY,2013,957478,355605,52658,286946,695209,0.7260835235900982
3278,Libya,LBY,2014,976793,361753,53599,293637,708989,0.7258334160871341
3279,Libya,LBY,2016,1011748,371705,55463,304972,732140,0.7236386926388785
3280,Libya,LBY,2017,1028254,375984,56411,310295,742690,0.7222826266661739
3281,Libya,LBY,2018,1044436,380843,57316,317299,755458,0.723316699156291
3282,Libya,LBY,2005,813193,303205,43677,230938,577820,0.7105570264377583
3283,Libya,LBY,2012,936517,348571,51608,279898,680077,0.7261768873389378
3284,Libya,LBY,2019,1060680,386127,58167,325500,769794,0.7257551759248784
3285,Libya,LBY,2004,792966,295938,42311,223271,561520,0.7081261996100715
3286,Libya,LBY,2002,750360,280383,39520,207768,527671,0.7032237859160936
3287,Libya,LBY,1990,542101,200619,26682,139314,366615,0.6762854154484127
3288,Libya,LBY,1991,552053,204673,27292,142305,374270,0.677960268307572
3289,Libya,LBY,1992,562442,208966,27949,145661,382576,0.6802052478299985
3290,Libya,LBY,1993,573794,213671,28675,149334,391680,0.6826143180305126
3291,Libya,LBY,1994,586853,218946,29488,153565,401999,0.6850080002999047
3292,Libya,LBY,1995,601862,224956,30398,158380,413734,0.6874233628306822
3293,Libya,LBY,2003,771927,288315,40922,215464,544701,0.7056379683571115
3294,Libya,LBY,1997,640526,239778,32653,170618,443049,0.6916955751991332
3295,Libya,LBY,1998,662050,247844,33936,177698,459478,0.6940231100370062
3296,Libya,LBY,1999,684178,256052,35295,185054,476401,0.6963114861921897
3297,Libya,LBY,2000,706417,264233,36699,192630,493562,0.6986836387006542
3298,Libya,LBY,2001,728533,272338,38119,200129,510586,0.7008412796674962
3299,Libya,LBY,1996,620276,232100,31474,164171,427745,0.6896043051802746
3300,Lithuania,LTU,2007,454111,156786,19141,166039,341966,0.7530449603731246
3301,Lithuania,LTU,2008,446868,154641,18921,163911,337473,0.7551961653105616
3302,Lithuania,LTU,2010,434151,150724,18496,160233,329453,0.7588442730754967
3303,Lithuania,LTU,2011,428049,148758,18285,158520,325563,0.7605741398765095
3304,Lithuania,LTU,2012,421879,146744,18079,156607,321430,0.7619009241986446
3305,Lithuania,LTU,2015,404912,141185,17452,150929,309566,0.7645266131900265
3306,Lithuania,LTU,2014,410125,142914,17661,152636,313211,0.7636964340140201
3307,Lithuania,LTU,2006,461401,158920,19354,168136,346410,0.7507786068950869
3308,Lithuania,LTU,2016,399549,138911,17231,149474,305616,0.7649024274869916
3309,Lithuania,LTU,2017,394546,136633,17013,148143,301789,0.7649019379235881
3310,Lithuania,LTU,2018,390030,134937,16802,146808,298547,0.765446247724534
3311,Lithuania,LTU,2019,385738,133448,16597,145335,295380,0.7657529203760065
3312,Lithuania,LTU,2013,415800,144771,17871,154544,317186,0.7628330928330929
3313,Lithuania,LTU,2004,475175,162745,19743,172098,354586,0.7462219182406482
3314,Lithuania,LTU,2009,440179,152621,18704,161953,333278,0.7571419808759619
3315,Lithuania,LTU,2005,468432,160921,19556,170125,350602,0.7484586877070738
3316,Lithuania,LTU,2003,482003,164379,19918,174362,358659,0.7441011777934992
3317,Lithuania,LTU,1990,490553,165130,20632,173002,358764,0.7313460523123902
3318,Lithuania,LTU,1991,493448,165815,20696,173978,360489,0.7305511421669558
3319,Lithuania,LTU,1992,495998,166365,20739,174921,362025,0.7298920560163549
3320,Lithuania,LTU,1994,498262,166740,20718,176005,363463,0.7294616085513244
3321,Lithuania,LTU,1995,498165,166590,20669,176247,363506,0.7296899621611314
3322,Lithuania,LTU,1993,497633,166694,20748,175607,363049,0.7295516977370874
3323,Lithuania,LTU,1997,499115,167408,20551,177655,365614,0.7325245684862206
3324,Lithuania,LTU,1998,499535,168051,20482,178552,367085,0.7348534136747175
3325,Lithuania,LTU,1999,498928,168312,20404,179123,367839,0.7372586826155277
3326,Lithuania,LTU,2000,497132,167911,20317,179159,367387,0.7390129784443569
3327,Lithuania,LTU,2001,493507,166971,20206,178299,365476,0.7405690294159961
3328,Lithuania,LTU,2002,488228,165786,20074,176537,362397,0.742270004997665
3329,Lithuania,LTU,1996,498252,166765,20610,176743,364118,0.7307908447933977
3330,Luxembourg,LUX,2010,71840,28027,5082,18830,51939,0.7229816258351893
3331,Luxembourg,LUX,2006,67726,26195,4710,18317,49222,0.7267814428727519
3332,Luxembourg,LUX,2007,68606,26612,4791,18369,49772,0.7254759058974434
3333,Luxembourg,LUX,2008,69539,27046,4881,18436,50363,0.7242410733545205
3334,Luxembourg,LUX,2009,70615,27522,4981,18579,51082,0.7233873822842173
3335,Luxembourg,LUX,2011,73319,28611,5196,19208,53015,0.7230731461149225
3336,Luxembourg,LUX,2005,66769,25766,4630,18194,48590,0.7277329299525229
3337,Luxembourg,LUX,2013,76868,30014,5472,20139,55625,0.7236431284799917
3338,Luxembourg,LUX,2014,78653,30711,5609,20621,56941,0.7239520425158608
3339,Luxembourg,LUX,2015,80541,31431,5753,21151,58335,0.7242894923082653
3340,Luxembourg,LUX,2016,82434,32079,5905,21695,59679,0.7239609869713953
3341,Luxembourg,LUX,2017,84444,32771,6064,22286,61121,0.7238051252901331
3342,Luxembourg,LUX,2018,86507,33562,6217,22854,62633,0.7240223334527842
3343,Luxembourg,LUX,2012,75087,29312,5334,19670,54316,0.7233742192390161
3344,Luxembourg,LUX,2019,88575,34382,6365,23443,64190,0.7246965848151284
3345,Luxembourg,LUX,2004,65904,25379,4558,18076,48013,0.728529376062151
3346,Luxembourg,LUX,2002,64526,24754,4439,17954,47147,0.730666707993677
3347,Luxembourg,LUX,1990,56888,21366,3895,16841,42102,0.740085782590353
3348,Luxembourg,LUX,1991,57240,21524,3923,16906,42353,0.7399196366177498
3349,Luxembourg,LUX,1992,57691,21719,3955,16988,42662,0.7394914284723787
3350,Luxembourg,LUX,1993,58233,21950,3992,17074,43016,0.7386876856765064
3351,Luxembourg,LUX,1994,58841,22211,4033,17173,43417,0.7378698526537618
3352,Luxembourg,LUX,1995,59514,22489,4077,17291,43857,0.7369190442584937
3353,Luxembourg,LUX,2003,65124,25027,4490,17983,47500,0.7293778023462932
3354,Luxembourg,LUX,1997,60962,23127,4176,17529,44832,0.7354089432761393
3355,Luxembourg,LUX,1998,61739,23480,4229,17631,45340,0.7343818332010561
3356,Luxembourg,LUX,1999,62515,23843,4285,17735,45863,0.733631928337199
3357,Luxembourg,LUX,2000,63255,24180,4339,17833,46352,0.7327800173899296
3358,Luxembourg,LUX,2001,63929,24484,4390,17909,46783,0.7317962114220463
3359,Luxembourg,LUX,1996,60225,22793,4125,17417,44335,0.7361560813615609
3360,Madagascar,MDG,2006,2020168,618166,89623,623967,1331756,0.659230321438613
3361,Madagascar,MDG,2007,2083858,637887,92544,643428,1373859,0.6592862853418995
3362,Madagascar,MDG,2008,2149565,658292,95576,663861,1417729,0.6595422794844539
3363,Madagascar,MDG,2009,2217114,679454,98714,684807,1462975,0.6598555599757162
3364,Madagascar,MDG,2010,2287061,701489,101964,707157,1510610,0.6605027150565727
3365,Madagascar,MDG,2011,2357760,725269,105328,729778,1560375,0.6618040004071661
3366,Madagascar,MDG,2014,2582459,806779,116083,804679,1727541,0.6689519562556463
3367,Madagascar,MDG,2013,2505804,778610,112389,778787,1669786,0.6663673615334639
3368,Madagascar,MDG,2015,2661204,834883,119885,831507,1786275,0.6712281358362606
3369,Madagascar,MDG,2016,2742103,865198,123786,858879,1847863,0.6738853354523882
3370,Madagascar,MDG,2017,2824266,895468,127789,887914,1911171,0.6766965292929207
3371,Madagascar,MDG,2005,1958997,599068,86814,605207,1291089,0.6590561394427863
3372,Madagascar,MDG,2019,2991460,946894,136091,952024,2035009,0.680272843360767
3373,Madagascar,MDG,2012,2431036,751194,108804,754285,1614283,0.6640308905339123
3374,Madagascar,MDG,2018,2907113,922247,131890,918761,1972898,0.6786451025467535
3375,Madagascar,MDG,2004,1899882,580276,84117,587539,1251932,0.6589525033659985
3376,Madagascar,MDG,2002,1789469,543659,79039,555328,1178026,0.6583103702830281
3377,Madagascar,MDG,2003,1843919,561720,81529,571009,1214258,0.6585202495337377
3378,Madagascar,MDG,1990,1264209,380928,55418,403229,839575,0.664110918368719
3379,Madagascar,MDG,1991,1300205,391743,56992,413166,861901,0.6628962355936179
3380,Madagascar,MDG,1992,1337108,402960,58633,423607,885200,0.6620258049461973
3381,Madagascar,MDG,1994,1415044,426637,62104,445803,934544,0.6604345871930484
3382,Madagascar,MDG,1995,1456370,439261,63952,457905,961118,0.6599408117442683
3383,Madagascar,MDG,1993,1375810,414562,60335,434574,909471,0.6610440395112698
3384,Madagascar,MDG,1997,1543255,465946,67867,483332,1017145,0.6590906881882774
3385,Madagascar,MDG,1998,1589021,480033,69932,496444,1046409,0.6585243366827751
3386,Madagascar,MDG,1999,1636084,494719,72078,510089,1076886,0.6582094806868107
3387,Madagascar,MDG,2000,1685522,510067,74312,524578,1108957,0.6579308961852768
3388,Madagascar,MDG,2001,1737052,526348,76633,539905,1142886,0.657945760978946
3389,Madagascar,MDG,1996,1499000,452365,65874,470511,988750,0.659606404269513
3390,Malawi,MWI,2011,1523218,464754,66598,406664,938016,0.6158120505403691
3391,Malawi,MWI,2007,1363885,409263,59348,369049,837660,0.6141720159690883
3392,Malawi,MWI,2008,1398130,421508,60947,375478,857933,0.6136289186270233
3393,Malawi,MWI,2009,1434859,434795,62682,383431,880908,0.6139334945106104
3394,Malawi,MWI,2010,1476920,449035,64565,393783,907383,0.6143751861983046
3395,Malawi,MWI,2012,1573433,482326,68790,421792,972908,0.6183345588912905
3396,Malawi,MWI,2006,1332779,398153,57887,362973,819013,0.6145152347088302
3397,Malawi,MWI,2014,1684302,521456,73677,455693,1050826,0.623894052254287
3398,Malawi,MWI,2015,1743253,541989,76377,473408,1091774,0.626285455983727
3399,Malawi,MWI,2016,1803054,563913,79211,490912,1134036,0.6289528766193359
3400,Malawi,MWI,2017,1864109,586041,82178,509042,1177261,0.6315408594669089
3401,Malawi,MWI,2018,1926688,606724,85292,528273,1220289,0.6333609800860337
3402,Malawi,MWI,2013,1627354,501376,71149,438381,1010906,0.6211961257353963
3403,Malawi,MWI,2005,1302295,388020,56542,356666,801228,0.615243090083276
3404,Malawi,MWI,2019,1990289,626609,88536,548764,1263909,0.635037926652863
3405,Malawi,MWI,2003,1241820,369472,54069,343173,766714,0.6174115411251228
3406,Malawi,MWI,1990,999767,292373,43004,281975,617352,0.6174958765392337
3407,Malawi,MWI,1991,1037599,303549,44649,292214,640412,0.617205683505863
3408,Malawi,MWI,1992,1062983,311075,45733,299318,656126,0.6172497584627412
3409,Malawi,MWI,1993,1055861,308961,45311,297837,652109,0.6176087572133074
3410,Malawi,MWI,1994,1035835,303139,44334,292945,640418,0.6182625611221865
3411,Malawi,MWI,1995,1043183,305449,44670,295251,645370,0.6186546368182764
3412,Malawi,MWI,2004,1271340,378497,55273,349784,783554,0.6163213617128385
3413,Malawi,MWI,1997,1090968,321087,47094,307681,675862,0.6195067133041482
3414,Malawi,MWI,1998,1113356,328746,48271,312971,689988,0.6197370831971085
3415,Malawi,MWI,1999,1135425,336367,49422,318332,704121,0.6201387145782417
3416,Malawi,MWI,2000,1159706,344239,50579,324072,718890,0.6198898686391207
3417,Malawi,MWI,2001,1186193,352467,51753,330538,734758,0.6194253380352102
3418,Malawi,MWI,2002,1213699,360873,52913,336983,750769,0.6185792358731448
3419,Malawi,MWI,1996,1067802,313308,45889,301875,661072,0.6190960496421621
3420,Malaysia,MYS,2007,3084411,1235745,90744,898589,2225078,0.7213947816941387
3421,Malaysia,MYS,2008,3134631,1260750,92720,915352,2268822,0.7237923698196056
3422,Malaysia,MYS,2009,3184034,1285322,94625,931324,2311271,0.7258939445998378
3423,Malaysia,MYS,2010,3234323,1309232,96512,948563,2354307,0.7279133840374014
3424,Malaysia,MYS,2011,3288930,1330325,98401,973478,2402204,0.7303907349806776
3425,Malaysia,MYS,2012,3347254,1348569,100283,1006746,2455598,0.7336156742213169
3426,Malaysia,MYS,2015,3520260,1406382,105774,1104383,2616539,0.7432800418150932
3427,Malaysia,MYS,2014,3465798,1385412,103962,1077732,2567106,0.7406969477159373
3428,Malaysia,MYS,2016,3568601,1429845,107531,1122027,2659403,0.7452228478330865
3429,Malaysia,MYS,2017,3616001,1452260,109239,1139377,2700876,0.7469234660056786
3430,Malaysia,MYS,2018,3665091,1471635,110897,1160075,2742607,0.7483052944660855
3431,Malaysia,MYS,2006,3030903,1210285,88724,881396,2180405,0.7193912177328011
3432,Malaysia,MYS,2013,3406671,1366410,102135,1043371,2511916,0.7373520953446928
3433,Malaysia,MYS,2005,2973944,1184743,86694,862114,2133551,0.7174146520580078
3434,Malaysia,MYS,2019,3715371,1489147,112508,1184287,2785942,0.7498422095666893
3435,Malaysia,MYS,2003,2812721,1132446,82503,779873,1994822,0.7092143159595281
3436,Malaysia,MYS,1990,1839362,710941,52785,477524,1241250,0.6748263800165493
3437,Malaysia,MYS,1991,1896620,735740,54626,494461,1284827,0.6774298488890763
3438,Malaysia,MYS,1992,1959024,762487,56615,511869,1330971,0.6794051527699507
3439,Malaysia,MYS,1993,2025004,790725,58735,530256,1379716,0.6813398887113309
3440,Malaysia,MYS,1994,2093022,820192,60974,549385,1430551,0.6834858878693105
3441,Malaysia,MYS,1995,2163325,850743,63279,569180,1483202,0.6856121941918112
3442,Malaysia,MYS,2004,2902574,1159018,84630,829504,2073152,0.7142460450620725
3443,Malaysia,MYS,1997,2313511,926278,68137,600160,1594575,0.6892446156512764
3444,Malaysia,MYS,1998,2391217,969047,70639,611891,1651577,0.690684701555735
3445,Malaysia,MYS,1999,2466685,1009477,73124,624823,1707424,0.6921937742354618
3446,Malaysia,MYS,2000,2538876,1044447,75558,642167,1762172,0.6940756460733017
3447,Malaysia,MYS,2001,2619392,1075030,77922,674683,1827635,0.6977325272429633
3448,Malaysia,MYS,2002,2714641,1104436,80254,723655,1908345,0.7029824569804994
3449,Malaysia,MYS,1996,2236713,885605,65665,586198,1537468,0.6873783091527612
3450,Maldives,MDV,2006,33756,11070,992,8826,20888,0.6187936959355373
3451,Maldives,MDV,2007,34685,11463,1038,9104,21605,0.6228917399452213
3452,Maldives,MDV,2008,35731,11895,1089,9423,22407,0.6271025160225014
3453,Maldives,MDV,2009,36900,12361,1145,9778,23284,0.6310027100271003
3454,Maldives,MDV,2010,38224,12856,1206,10181,24243,0.6342350355797405
3455,Maldives,MDV,2011,39706,13391,1271,10629,25291,0.6369566312396111
3456,Maldives,MDV,2015,46727,15874,1561,12701,30136,0.6449376163674108
3457,Maldives,MDV,2013,43033,14596,1412,11612,27620,0.6418330118746078
3458,Maldives,MDV,2014,44849,15237,1486,12141,28864,0.6435817966955785
3459,Maldives,MDV,2016,48627,16509,1636,13278,31423,0.6462047833508133
3460,Maldives,MDV,2017,50566,17144,1712,13870,32726,0.6471937665625124
3461,Maldives,MDV,2018,52545,17795,1787,14479,34061,0.6482253306689504
3462,Maldives,MDV,2005,32936,10719,951,8564,20234,0.6143429681807141
3463,Maldives,MDV,2012,41303,13975,1340,11102,26417,0.6395903445270319
3464,Maldives,MDV,2019,54555,18472,1862,15100,35434,0.6495096691412336
3465,Maldives,MDV,2004,32191,10405,915,8326,19646,0.6102948028952192
3466,Maldives,MDV,2002,30857,9833,850,7914,18597,0.6026833457562304
3467,Maldives,MDV,2003,31509,10113,881,8116,19110,0.6064933828429973
3468,Maldives,MDV,1990,22449,6547,559,5636,12742,0.5675976658203038
3469,Maldives,MDV,1991,23151,6783,577,5809,13169,0.5688307200552892
3470,Maldives,MDV,1992,23877,7034,595,5984,13613,0.5701302508690371
3471,Maldives,MDV,1994,25393,7571,637,6365,14573,0.5738983184342141
3472,Maldives,MDV,1995,26166,7850,661,6573,15084,0.5764732859435909
3473,Maldives,MDV,1993,24634,7298,616,6170,14084,0.5717301290898757
3474,Maldives,MDV,1997,27604,8419,711,6962,16092,0.5829589914505144
3475,Maldives,MDV,1998,28286,8709,737,7147,16593,0.5866152867142757
3476,Maldives,MDV,1999,28945,8998,765,7330,17093,0.5905337709448955
3477,Maldives,MDV,2000,29582,9282,793,7520,17595,0.5947873706983977
3478,Maldives,MDV,2001,30225,9558,821,7718,18097,0.5987427626137304
3479,Maldives,MDV,1996,26909,8132,685,6778,15595,0.5795458768441786
3480,Mali,MLI,2011,1428204,377665,65984,376124,819773,0.5739887299013307
3481,Mali,MLI,2007,1234066,324690,57206,328179,710075,0.5753946709495278
3482,Mali,MLI,2008,1281547,337357,59360,339331,736048,0.5743433522141599
3483,Mali,MLI,2009,1331388,350739,61632,351151,763522,0.5734782047006582
3484,Mali,MLI,2010,1380280,364080,63853,363207,791140,0.5731735589880315
3485,Mali,MLI,2012,1481673,393417,68362,391371,853150,0.5758018132205959
3486,Mali,MLI,2006,1189170,312675,55174,317768,685617,0.5765508716163374
3487,Mali,MLI,2014,1603520,429936,73886,427114,930936,0.5805577728996208
3488,Mali,MLI,2015,1666226,448716,76842,444914,970472,0.5824371963947268
3489,Mali,MLI,2016,1729653,468442,79944,463002,1011388,0.5847346259625485
3490,Mali,MLI,2017,1796472,488474,83180,481515,1053169,0.5862429250219319
3491,Mali,MLI,2018,1866018,508053,86525,502113,1096691,0.5877172674647297
3492,Mali,MLI,2013,1541601,411297,71053,408945,891295,0.5781619238700546
3493,Mali,MLI,2005,1147386,301239,53264,307729,662232,0.5771658360830618
3494,Mali,MLI,2019,1940513,527931,89988,525718,1143637,0.5893477652558885
3495,Mali,MLI,2003,1072022,279773,49758,289313,618844,0.5772680038282797
3496,Mali,MLI,1990,781862,196219,35410,217494,449123,0.5744274565076701
3497,Mali,MLI,1991,793554,199443,35949,220718,456110,0.5747686987905045
3498,Mali,MLI,1992,805413,202758,36508,223884,463150,0.5750465910036218
3499,Mali,MLI,1993,819542,206722,37195,227855,471772,0.575653230706907
3500,Mali,MLI,1994,839087,212092,38153,233088,483333,0.5760225101807083
3501,Mali,MLI,1995,861370,218256,39261,238886,496403,0.5762947397750096
3502,Mali,MLI,2004,1108311,290250,51460,298266,639976,0.5774335903911447
3503,Mali,MLI,1997,905646,230883,41508,249609,522000,0.5763841500983828
3504,Mali,MLI,1998,928238,237597,42682,254616,534895,0.5762476864769596
3505,Mali,MLI,1999,952785,244776,43924,260187,548887,0.5760869451135355
3506,Mali,MLI,2000,979782,252485,45248,266527,564260,0.5759036193765552
3507,Mali,MLI,2001,1008369,260835,46657,273523,581015,0.576192842104428
3508,Mali,MLI,2002,1038968,269946,48159,281114,599219,0.5767444233123638
3509,Mali,MLI,1996,883624,224473,40373,244482,509328,0.5764080649688103
3510,Malta,MLT,2007,63492,28187,4400,14741,47328,0.7454167454167454
3511,Malta,MLT,2009,63927,28450,4475,14832,47757,0.7470552348772819
3512,Malta,MLT,2010,64166,28563,4507,14923,47993,0.7479506280584733
3513,Malta,MLT,2011,64430,28675,4536,15070,48281,0.7493558901133013
3514,Malta,MLT,2012,64706,28789,4562,15238,48589,0.7509195437826477
3515,Malta,MLT,2015,65447,29052,4615,15702,49369,0.7543355692392317
3516,Malta,MLT,2014,65257,28991,4601,15581,49173,0.7535283571111145
3517,Malta,MLT,2006,63213,28025,4358,14676,47059,0.7444512995744547
3518,Malta,MLT,2016,65472,28963,4627,15763,49353,0.7538031524926686
3519,Malta,MLT,2017,65476,28861,4636,15823,49320,0.7532531003726556
3520,Malta,MLT,2018,65729,28906,4642,16044,49592,0.7544919289811195
3521,Malta,MLT,2019,66170,29012,4643,16423,50078,0.7568082212482998
3522,Malta,MLT,2013,65002,28902,4584,15417,48903,0.7523306975169994
3523,Malta,MLT,2005,62860,27839,4313,14578,46730,0.7433980273623926
3524,Malta,MLT,2008,63727,28332,4440,14779,47551,0.7461672446529728
3525,Malta,MLT,2003,61975,27356,4219,14314,45889,0.740443727309399
3526,Malta,MLT,1990,55174,23770,3621,12622,40013,0.7252147750752166
3527,Malta,MLT,1991,55659,24055,3663,12677,40395,0.7257586374171293
3528,Malta,MLT,1992,56165,24347,3705,12753,40805,0.7265200747796671
3529,Malta,MLT,1993,56680,24638,3749,12843,41230,0.7274170783345095
3530,Malta,MLT,1994,57212,24925,3794,12955,41674,0.7284136195203803
3531,Malta,MLT,1995,57725,25194,3839,13090,42123,0.7297184928540493
3532,Malta,MLT,2004,62434,27616,4267,14447,46330,0.742063619181856
3533,Malta,MLT,1997,58773,25710,3932,13391,43033,0.7321899511680534
3534,Malta,MLT,1998,59317,25978,3980,13542,43500,0.7333479440969705
3535,Malta,MLT,1999,59866,26246,4029,13708,43983,0.7346908094744931
3536,Malta,MLT,2000,60387,26504,4077,13871,44452,0.7361187010449269
3537,Malta,MLT,2001,60927,26778,4123,14015,44916,0.737210103894825
3538,Malta,MLT,2002,61458,27068,4170,14168,45406,0.7388134986494842
3539,Malta,MLT,1996,58245,25449,3884,13234,42567,0.7308266804017512
3540,Marshall Islands,MHL,2006,5873,1978,125,1315,3418,0.5819853567171803
3541,Marshall Islands,MHL,2007,5904,1996,127,1327,3450,0.584349593495935
3542,Marshall Islands,MHL,2008,5937,2015,128,1339,3482,0.5864914940205491
3543,Marshall Islands,MHL,2009,5972,2035,129,1351,3515,0.5885800401875418
3544,Marshall Islands,MHL,2010,6006,2053,131,1364,3548,0.5907425907425907
3545,Marshall Islands,MHL,2011,6045,2071,132,1379,3582,0.5925558312655087
3546,Marshall Islands,MHL,2015,6222,2151,138,1444,3733,0.5999678559948569
3547,Marshall Islands,MHL,2013,6131,2110,135,1410,3655,0.5961507095090524
3548,Marshall Islands,MHL,2014,6176,2131,136,1427,3694,0.5981217616580311
3549,Marshall Islands,MHL,2016,6261,2166,139,1463,3768,0.6018207954000958
3550,Marshall Islands,MHL,2017,6302,2181,141,1482,3804,0.6036178990796572
3551,Marshall Islands,MHL,2018,6355,2203,142,1502,3847,0.6053501180173092
3552,Marshall Islands,MHL,2005,5842,1963,124,1299,3386,0.5795960287572749
3553,Marshall Islands,MHL,2012,6088,2090,133,1394,3617,0.5941195795006571
3554,Marshall Islands,MHL,2019,6414,2231,144,1524,3899,0.6078889928281883
3555,Marshall Islands,MHL,2004,5811,1952,122,1282,3356,0.5775253828945104
3556,Marshall Islands,MHL,2002,5748,1933,118,1243,3294,0.5730688935281837
3557,Marshall Islands,MHL,1990,4682,1534,88,934,2556,0.5459205467748826
3558,Marshall Islands,MHL,1991,4803,1580,90,959,2629,0.5473662294399334
3559,Marshall Islands,MHL,1992,4918,1624,93,986,2703,0.5496136640910939
3560,Marshall Islands,MHL,1993,5031,1667,96,1012,2775,0.5515802027429935
3561,Marshall Islands,MHL,1994,5140,1709,98,1039,2846,0.5536964980544747
3562,Marshall Islands,MHL,1995,5241,1748,101,1067,2916,0.5563823697767601
3563,Marshall Islands,MHL,2003,5782,1943,120,1263,3326,0.575233483223798
3564,Marshall Islands,MHL,1997,5432,1819,106,1122,3047,0.5609351988217968
3565,Marshall Islands,MHL,1998,5516,1851,109,1148,3108,0.5634517766497462
3566,Marshall Islands,MHL,1999,5590,1879,112,1173,3164,0.5660107334525939
3567,Marshall Islands,MHL,2000,5656,1903,114,1197,3214,0.5682461103253182
3568,Marshall Islands,MHL,2001,5706,1921,116,1221,3258,0.5709779179810726
3569,Marshall Islands,MHL,1996,5340,1784,104,1095,2983,0.5586142322097378
3570,Mauritania,MRT,2007,276794,76358,13833,80352,170543,0.6161369104821637
3571,Mauritania,MRT,2008,283073,78222,14183,82163,174568,0.6166889812875124
3572,Mauritania,MRT,2009,289574,80173,14545,84124,178842,0.6176037903955466
3573,Mauritania,MRT,2010,296504,82241,14920,86219,183380,0.6184739497612174
3574,Mauritania,MRT,2011,304119,84454,15306,88696,188456,0.619678481120877
3575,Mauritania,MRT,2012,312533,86805,15708,91547,194060,0.6209264301689742
3576,Mauritania,MRT,2015,339439,94383,17020,100971,212374,0.625661753658242
3577,Mauritania,MRT,2014,330400,91806,16563,97918,206287,0.6243553268765133
3578,Mauritania,MRT,2016,348366,97103,17496,103786,218385,0.6268837946297859
3579,Mauritania,MRT,2017,357350,99851,17992,106679,224522,0.6282971876311739
3580,Mauritania,MRT,2018,366733,102500,18505,110143,231148,0.6302896112430569
3581,Mauritania,MRT,2006,270664,74536,13491,78597,166624,0.6156119764726746
3582,Mauritania,MRT,2013,321354,89264,16125,94735,200124,0.6227524785750294
3583,Mauritania,MRT,2019,376294,105132,19040,113968,238140,0.6328562241226275
3584,Mauritania,MRT,2005,264500,72733,13156,76854,162743,0.6152854442344046
3585,Mauritania,MRT,2003,252311,69123,12505,73470,155098,0.6147096242335848
3586,Mauritania,MRT,2004,258360,70923,12827,75126,158876,0.614940393249729
3587,Mauritania,MRT,1990,185564,49836,8955,55388,114179,0.6153079261063569
3588,Mauritania,MRT,1991,190339,51156,9196,56744,117096,0.6151970957081838
3589,Mauritania,MRT,1992,195145,52494,9440,58055,119989,0.6148709933639089
3590,Mauritania,MRT,1994,204914,55227,9939,60758,125924,0.6145212137774871
3591,Mauritania,MRT,1995,209858,56634,10197,62137,128968,0.6145488854368192
3592,Mauritania,MRT,1993,200021,53847,9685,59429,122961,0.6147404522525135
3593,Mauritania,MRT,1997,219727,59500,10731,64774,135005,0.614421532174016
3594,Mauritania,MRT,1998,224717,60963,11006,66053,138022,0.6142036428040603
3595,Mauritania,MRT,1999,229819,62471,11292,67391,141154,0.6141963893324747
3596,Mauritania,MRT,2000,235135,64030,11586,68845,144461,0.614374720905012
3597,Mauritania,MRT,2001,240709,65658,11885,70376,147919,0.6145137905105335
3598,Mauritania,MRT,2002,246452,67364,12192,71905,151461,0.6145659195299693
3599,Mauritania,MRT,1996,214827,58058,10461,63496,132015,0.61451772821852
3600,Mauritius,MUS,2011,160483,52907,4786,57521,115214,0.7179202781603036
3601,Mauritius,MUS,2007,158416,51146,4625,56863,112634,0.711001413998586
3602,Mauritius,MUS,2008,159168,51682,4670,57130,113482,0.7129699437072778
3603,Mauritius,MUS,2009,159752,52170,4711,57364,114245,0.715139716560669
3604,Mauritius,MUS,2010,160277,52574,4748,57567,114889,0.7168152635749359
3605,Mauritius,MUS,2012,160240,53202,4823,57095,115120,0.7184223664503245
3606,Mauritius,MUS,2006,157642,50614,4580,56593,111787,0.7091193971149821
3607,Mauritius,MUS,2014,159575,53698,4896,56185,114779,0.7192793357355476
3608,Mauritius,MUS,2015,159666,53906,4929,56240,115075,0.7207232598048426
3609,Mauritius,MUS,2016,159779,53903,4959,56584,115446,0.7225355021623617
3610,Mauritius,MUS,2017,159887,53886,4987,56924,115797,0.724242746439673
3611,Mauritius,MUS,2018,160240,54088,5013,57300,116401,0.7264166250624063
3612,Mauritius,MUS,2019,160656,54381,5036,57638,117055,0.7286064634996514
3613,Mauritius,MUS,2013,159879,53465,4860,56565,114890,0.7186059457464707
3614,Mauritius,MUS,2005,156781,50132,4536,56266,110934,0.707572983971272
3615,Mauritius,MUS,2004,155946,49673,4491,55985,110149,0.7063278314288279
3616,Mauritius,MUS,2003,154902,49193,4442,55666,109301,0.7056138719964881
3617,Mauritius,MUS,1990,133455,41239,3660,44403,89302,0.6691543966130905
3618,Mauritius,MUS,1991,134919,41879,3719,45037,90635,0.671773434431029
3619,Mauritius,MUS,1992,136482,42538,3781,45750,92069,0.6745871250421301
3620,Mauritius,MUS,1993,138088,43204,3846,46492,93542,0.6774086090029546
3621,Mauritius,MUS,1995,141345,44504,3979,48130,96613,0.6835261240227811
3622,Mauritius,MUS,1996,143129,45139,4044,49146,98329,0.68699564728322
3623,Mauritius,MUS,1994,139719,43864,3913,47291,95068,0.6804228487177836
3624,Mauritius,MUS,1998,147400,46423,4171,51927,102521,0.695529172320217
3625,Mauritius,MUS,1999,149505,47043,4231,53287,104561,0.6993812915955988
3626,Mauritius,MUS,2000,151195,47619,4287,54261,106167,0.7021859188465227
3627,Mauritius,MUS,2001,152554,48159,4340,54865,107364,0.7037770232180081
3628,Mauritius,MUS,2002,153776,48685,4392,55323,108400,0.7049214441785454
3629,Mauritius,MUS,1997,145215,45781,4108,50480,100369,0.6911751540818786
3630,Mexico,MEX,2011,13426656,4271896,1072103,3902003,9246002,0.6886302888820567
3631,Mexico,MEX,2007,12480226,4048808,1003845,3382712,8435365,0.6758984172241753
3632,Mexico,MEX,2008,12753082,4121969,1021086,3533233,8676288,0.6803287236763631
3633,Mexico,MEX,2009,13012027,4187118,1038191,3678399,8903708,0.6842675626172617
3634,Mexico,MEX,2010,13238432,4241480,1055256,3799031,9095767,0.687072834607603
3635,Mexico,MEX,2012,13590604,4278134,1088798,4004220,9371152,0.6895316793867292
3636,Mexico,MEX,2019,14774237,4533743,1197480,4560220,10291443,0.6965803377866485
3637,Mexico,MEX,2014,13891082,4282274,1121426,4191434,9595134,0.690740577299882
3638,Mexico,MEX,2015,14054387,4313353,1137475,4271748,9722576,0.6917822883345962
3639,Mexico,MEX,2016,14242162,4364252,1153078,4343889,9861219,0.6923962106315038
3640,Mexico,MEX,2017,14427103,4417349,1168242,4414464,10000055,0.6931436616207703
3641,Mexico,MEX,2018,14600008,4473452,1183000,4486785,10143237,0.6947418795934907
3642,Mexico,MEX,2006,12214513,3970972,986586,3246747,8204305,0.6716849865401919
3643,Mexico,MEX,2013,13739986,4276128,1105237,4101563,9482928,0.690170135544534
3644,Mexico,MEX,2005,11974597,3891704,969447,3142074,8003225,0.6683502584679886
3645,Mexico,MEX,2004,11737273,3795354,952264,3059489,7807107,0.6651551003371907
3646,Mexico,MEX,2003,11476454,3673207,935184,2978534,7586925,0.6610861682537132
3647,Mexico,MEX,1991,8495602,2284335,719839,2123021,5127195,0.6035116758059053
3648,Mexico,MEX,1992,8695622,2339666,740112,2190761,5270539,0.6061140882158861
3649,Mexico,MEX,1993,8899797,2396974,760604,2260806,5418384,0.6088210776043543
3650,Mexico,MEX,1994,9105702,2454923,780860,2331980,5567763,0.6114589517645097
3651,Mexico,MEX,1995,9307173,2512126,800394,2401620,5714140,0.6139501221262353
3652,Mexico,MEX,1996,9535775,2605303,818652,2470593,5894548,0.6181509106496326
3653,Mexico,MEX,1990,8305259,2232282,700217,2058860,4991359,0.6009877596833524
3654,Mexico,MEX,1998,10106053,2934197,852526,2610131,6396854,0.6329725363601398
3655,Mexico,MEX,1999,10403782,3113971,868735,2680425,6663131,0.6404527699638458
3656,Mexico,MEX,2000,10676245,3264551,884956,2751392,6900899,0.6463788532391305
3657,Mexico,MEX,2001,10935497,3397177,901463,2824453,7123093,0.6513735041031972
3658,Mexico,MEX,2002,11205201,3536874,918242,2900267,7355383,0.6564257972703925
3659,Mexico,MEX,1997,9809302,2755082,835942,2540247,6131271,0.6250466139180952
3660,Micronesia (country),FSM,2008,11773,4019,250,2639,6908,0.5867663297375351
3661,Micronesia (country),FSM,2009,11763,4032,251,2647,6930,0.5891354246365723
3662,Micronesia (country),FSM,2010,11757,4040,252,2657,6949,0.591052139151144
3663,Micronesia (country),FSM,2011,11754,4050,253,2671,6974,0.5933299302365153
3664,Micronesia (country),FSM,2012,11761,4064,254,2687,7005,0.595612617974662
3665,Micronesia (country),FSM,2013,11769,4079,256,2704,7039,0.5980966947064321
3666,Micronesia (country),FSM,2016,11756,4089,260,2752,7101,0.6040319836679142
3667,Micronesia (country),FSM,2015,11776,4099,258,2736,7093,0.6023267663043478
3668,Micronesia (country),FSM,2017,11735,4079,261,2769,7109,0.6057946314443972
3669,Micronesia (country),FSM,2018,11732,4088,262,2788,7138,0.6084214115240368
3670,Micronesia (country),FSM,2019,11750,4109,264,2815,7188,0.6117446808510638
3671,Micronesia (country),FSM,2007,11783,4006,249,2635,6890,0.5847407281676992
3672,Micronesia (country),FSM,2014,11775,4092,257,2721,7070,0.6004246284501061
3673,Micronesia (country),FSM,2006,11796,3996,248,2629,6873,0.5826551373346898
3674,Micronesia (country),FSM,2005,11817,3995,247,2623,6865,0.5809427096555809
3675,Micronesia (country),FSM,1990,10962,3618,212,2318,6148,0.5608465608465608
3676,Micronesia (country),FSM,1991,11132,3679,216,2360,6255,0.561893639956881
3677,Micronesia (country),FSM,1992,11284,3736,220,2398,6354,0.5630981921304502
3678,Micronesia (country),FSM,1993,11424,3789,224,2434,6447,0.5643382352941176
3679,Micronesia (country),FSM,1994,11547,3837,227,2467,6531,0.5656014549233567
3680,Micronesia (country),FSM,1995,11652,3880,230,2495,6605,0.5668554754548575
3681,Micronesia (country),FSM,1996,11744,3919,233,2521,6673,0.5682050408719346
3682,Micronesia (country),FSM,2004,11848,4003,246,2616,6865,0.5794226873733963
3683,Micronesia (country),FSM,1998,11873,3990,237,2553,6780,0.5710435441758612
3684,Micronesia (country),FSM,1999,11911,4016,239,2565,6820,0.5725799680967173
3685,Micronesia (country),FSM,2000,11938,4033,241,2578,6852,0.5739654883565086
3686,Micronesia (country),FSM,2001,11940,4037,243,2590,6870,0.5753768844221105
3687,Micronesia (country),FSM,2002,11918,4029,244,2600,6873,0.5766907199194495
3688,Micronesia (country),FSM,2003,11883,4016,245,2608,6869,0.5780526802995877
3689,Micronesia (country),FSM,1997,11817,3957,235,2539,6731,0.5696031141575696
3690,Middle East & North Africa (WB),,2007,55695494,19418127,2810457,14945108,37173692,0.667445233540796
3691,Middle East & North Africa (WB),,2008,57162717,20119759,2897921,15452478,38470158,0.6729938676637781
3692,Middle East & North Africa (WB),,2009,58560115,20774246,2980591,15940915,39695752,0.6778632862998988
3693,Middle East & North Africa (WB),,2010,59762467,21281698,3052082,16379463,40713243,0.6812510434015383
3694,Middle East & North Africa (WB),,2011,60929977,21717691,3120635,16836155,41674481,0.683973358466884
3695,Middle East & North Africa (WB),,2012,62122974,22154654,3185416,17334339,42674409,0.6869344181751504
3696,Middle East & North Africa (WB),,2016,66380490,23565366,3418735,19073688,46057789,0.6938452698978269
3697,Middle East & North Africa (WB),,2014,64377783,22969054,3301460,18298706,44569220,0.6923074688670158
3698,Middle East & North Africa (WB),,2015,65448265,23346792,3358985,18714935,45420712,0.6939941341454965
3699,Middle East & North Africa (WB),,2017,67350717,23783428,3479920,19432893,46696241,0.6933295305527334
3700,Middle East & North Africa (WB),,2018,68502675,24206705,3542652,19824587,47573944,0.6944830110648964
3701,Middle East & North Africa (WB),,2019,69724333,24718102,3607070,20232420,48557592,0.6964224670317033
3702,Middle East & North Africa (WB),,2006,54326525,18779511,2726533,14465358,35971402,0.6621333133308269
3703,Middle East & North Africa (WB),,2013,63275254,22573316,3244996,17830993,43649305,0.6898321577658147
3704,Middle East & North Africa (WB),,2004,52034271,17849038,2572839,13611780,34033657,0.6540623390303671
3705,Middle East & North Africa (WB),,2000,47706211,16154463,2282862,12055076,30492401,0.6391704635691986
3706,Middle East & North Africa (WB),,2003,50939702,17414702,2497700,13205401,33117803,0.6501373525899308
3707,Middle East & North Africa (WB),,1990,37312807,12526948,1677733,9083653,23288334,0.6241378194891636
3708,Middle East & North Africa (WB),,1991,38337762,12896748,1730815,9350166,23977729,0.625433717283758
3709,Middle East & North Africa (WB),,1992,39302098,13245020,1782475,9608853,24636348,0.626845620302509
3710,Middle East & North Africa (WB),,1993,40336090,13624757,1838034,9889531,25352322,0.6285270089391412
3711,Middle East & North Africa (WB),,2005,53120920,18270804,2647634,14023624,34942062,0.6577834495336301
3712,Middle East & North Africa (WB),,1995,42470452,14421197,1955810,10495128,26872135,0.6327254299059497
3713,Middle East & North Africa (WB),,1994,41409598,14023647,1896420,10186822,26106889,0.6304550215628754
3714,Middle East & North Africa (WB),,1997,44565348,15126921,2081445,11102445,28310811,0.6352651167449652
3715,Middle East & North Africa (WB),,1998,45607897,15449006,2147454,11401869,28998329,0.6358181566670351
3716,Middle East & North Africa (WB),,1999,46654605,15782701,2214863,11716205,29713769,0.6368882342911273
3717,Middle East & North Africa (WB),,2001,48760011,16556446,2351417,12419673,31327536,0.6424841864781368
3718,Middle East & North Africa (WB),,2002,49827165,16974410,2422814,12801263,32198487,0.6462034715400725
3719,Middle East & North Africa (WB),,1996,43524141,14793062,2017470,10803541,27614073,0.634454175672301
3720,Moldova,MDA,2011,509232,173836,23216,151677,348729,0.6848136016589688
3721,Moldova,MDA,2007,528297,177700,23576,154079,355355,0.6726424719428654
3722,Moldova,MDA,2008,522863,176645,23501,153186,353332,0.6757640146654095
3723,Moldova,MDA,2009,517582,175649,23417,152370,351436,0.6789957919711272
3724,Moldova,MDA,2010,512992,174675,23314,151886,349875,0.6820281797766827
3725,Moldova,MDA,2012,505884,173194,23115,151615,347924,0.6877545049853326
3726,Moldova,MDA,2006,533628,178745,23644,155093,357482,0.6699086254844199
3727,Moldova,MDA,2014,499754,172031,22901,151393,346325,0.6929909515481617
3728,Moldova,MDA,2015,496656,171334,22773,151203,345310,0.6952699655294611
3729,Moldova,MDA,2016,493553,170167,22650,151299,344116,0.6972219802128646
3730,Moldova,MDA,2017,490867,169015,22526,151517,343058,0.698881774492887
3731,Moldova,MDA,2018,488222,168332,22414,151164,341910,0.700316659224697
3732,Moldova,MDA,2019,485490,167819,22301,150412,340532,0.7014191847411894
3733,Moldova,MDA,2013,502784,172614,23012,151494,347120,0.6903958757637475
3734,Moldova,MDA,2005,538788,179841,23698,156088,359627,0.667474034314053
3735,Moldova,MDA,1990,552663,184632,23581,167280,375493,0.6794248936512848
3736,Moldova,MDA,2003,548536,181951,23767,158280,363998,0.6635808770983126
3737,Moldova,MDA,1991,554942,185217,23637,166766,375620,0.6768635280804121
3738,Moldova,MDA,1992,556739,185627,23681,166155,375463,0.6743967999367747
3739,Moldova,MDA,1993,558367,185930,23709,165516,375155,0.6718788896908305
3740,Moldova,MDA,1994,559241,185979,23715,164776,374470,0.6696039811101118
3741,Moldova,MDA,1995,559629,185783,23704,163971,373458,0.6673313927619905
3742,Moldova,MDA,1996,560338,185524,23694,163302,372520,0.6648130235679179
3743,Moldova,MDA,2004,543610,180889,23740,157050,361679,0.6653280844723239
3744,Moldova,MDA,1998,563264,185211,23724,162296,371231,0.6590710572662197
3745,Moldova,MDA,1999,563391,184935,23750,161941,370626,0.65784863442973
3746,Moldova,MDA,2000,561473,184472,23771,161441,369684,0.6584181251814424
3747,Moldova,MDA,2001,557786,183792,23785,160630,368207,0.6601223408260516
3748,Moldova,MDA,2002,553474,182969,23784,159525,366278,0.661779957143425
3749,Moldova,MDA,1997,561841,185372,23704,162808,371884,0.6619025667404124
3750,Monaco,MCO,2008,5407,2014,365,1744,4123,0.7625300536341779
3751,Monaco,MCO,2009,5451,2031,368,1759,4158,0.7627958172812328
3752,Monaco,MCO,2010,5495,2047,371,1773,4191,0.7626933575978162
3753,Monaco,MCO,2011,5537,2065,374,1787,4226,0.7632291854795016
3754,Monaco,MCO,2012,5578,2083,376,1800,4259,0.7635353173180351
3755,Monaco,MCO,2013,5616,2100,379,1813,4292,0.7642450142450142
3756,Monaco,MCO,2016,5713,2139,386,1843,4368,0.7645720287064589
3757,Monaco,MCO,2015,5683,2129,384,1835,4348,0.7650888615168046
3758,Monaco,MCO,2017,5727,2143,387,1848,4378,0.7644491007508294
3759,Monaco,MCO,2018,5750,2153,389,1856,4398,0.7648695652173914
3760,Monaco,MCO,2019,5779,2166,391,1866,4423,0.765357328257484
3761,Monaco,MCO,2007,5361,1996,362,1727,4085,0.761984704346204
3762,Monaco,MCO,2014,5651,2116,381,1824,4321,0.764643425942311
3763,Monaco,MCO,2006,5316,1980,359,1712,4051,0.7620391271632807
3764,Monaco,MCO,2005,5272,1963,356,1698,4017,0.7619499241274659
3765,Monaco,MCO,1990,4728,1768,323,1536,3627,0.7671319796954315
3766,Monaco,MCO,2004,5228,1946,353,1685,3984,0.7620504973221117
3767,Monaco,MCO,1991,4767,1782,325,1549,3656,0.7669393748688903
3768,Monaco,MCO,1992,4805,1794,328,1562,3684,0.7667013527575443
3769,Monaco,MCO,1993,4839,1806,330,1573,3709,0.7664806778259972
3770,Monaco,MCO,1995,4905,1828,333,1594,3755,0.7655453618756372
3771,Monaco,MCO,1996,4937,1839,335,1603,3777,0.7650394976706502
3772,Monaco,MCO,1994,4873,1817,331,1584,3732,0.765852657500513
3773,Monaco,MCO,1998,5000,1862,338,1622,3822,0.7644
3774,Monaco,MCO,1999,5033,1874,340,1631,3845,0.7639578780051659
3775,Monaco,MCO,2000,5069,1887,342,1641,3870,0.7634641941211284
3776,Monaco,MCO,2001,5107,1901,344,1652,3897,0.7630702956726062
3777,Monaco,MCO,2002,5147,1916,347,1663,3926,0.7627744317077909
3778,Monaco,MCO,2003,5188,1931,350,1674,3955,0.7623361603700848
3779,Monaco,MCO,1997,4968,1850,336,1612,3798,0.7644927536231884
3780,Mongolia,MNG,2011,305728,53791,15042,111483,180316,0.5897922336194265
3781,Mongolia,MNG,2007,289332,50240,13681,101491,165412,0.5717030954059696
3782,Mongolia,MNG,2008,293195,51130,14037,103787,168954,0.5762513003291325
3783,Mongolia,MNG,2009,297158,52016,14379,106195,172590,0.5808021321990322
3784,Mongolia,MNG,2010,301435,52905,14720,108815,176440,0.5853334881483571
3785,Mongolia,MNG,2012,310185,54718,15354,114157,184229,0.5939326530941212
3786,Mongolia,MNG,2006,285314,49370,13316,99001,161687,0.5666984445207736
3787,Mongolia,MNG,2014,319360,56795,15929,119259,191983,0.6011491733466934
3788,Mongolia,MNG,2015,324694,57982,16201,121830,196013,0.6036853160206225
3789,Mongolia,MNG,2016,333846,62945,16458,124582,203985,0.6110152585323773
3790,Mongolia,MNG,2017,343228,68125,16708,127128,211961,0.6175515983544466
3791,Mongolia,MNG,2018,348708,69629,16949,128864,215442,0.6178292439519598
3792,Mongolia,MNG,2019,353270,70865,17188,129667,217720,0.6162991479604835
3793,Mongolia,MNG,2013,314717,55710,15648,116768,188126,0.5977624341869044
3794,Mongolia,MNG,2005,281215,48516,12952,96392,157860,0.5613498568710773
3795,Mongolia,MNG,1990,214611,40123,8941,65937,115001,0.5358579010395553
3796,Mongolia,MNG,2003,274508,48930,12240,91046,152216,0.5545047867457414
3797,Mongolia,MNG,2004,277453,48310,12588,93634,154532,0.5569664051208674
3798,Mongolia,MNG,1991,220060,41031,9157,67772,117960,0.536035626647278
3799,Mongolia,MNG,1992,225300,41929,9369,69489,120787,0.5361162893919219
3800,Mongolia,MNG,1993,230351,42821,9579,71202,123602,0.536581130535574
3801,Mongolia,MNG,1995,240201,44659,10013,74641,129313,0.5383532957814497
3802,Mongolia,MNG,1996,244962,45628,10238,76386,132252,0.5398878193352439
3803,Mongolia,MNG,1994,235336,43730,9794,72908,126432,0.5372403712139239
3804,Mongolia,MNG,1998,254431,47663,10717,79912,138292,0.5435343963589343
3805,Mongolia,MNG,1999,259136,48685,10982,81844,141511,0.5460877685848358
3806,Mongolia,MNG,2000,264061,49725,11276,83923,144924,0.5488277329859389
3807,Mongolia,MNG,2001,268253,50151,11580,86154,147885,0.5512892679671803
3808,Mongolia,MNG,2002,271573,49728,11906,88531,150165,0.5529452486071885
3809,Mongolia,MNG,1997,249726,46632,10470,78127,135229,0.5415094944058688
3810,Montenegro,MNE,2011,73776,25358,3807,20874,50039,0.6782558013446107
3811,Montenegro,MNE,2007,74137,25310,3797,20743,49850,0.6724037929778653
3812,Montenegro,MNE,2008,74056,25334,3801,20781,49916,0.6740304634330777
3813,Montenegro,MNE,2009,73944,25350,3803,20807,49960,0.675646435140106
3814,Montenegro,MNE,2010,73859,25361,3805,20843,50009,0.6770874233336492
3815,Montenegro,MNE,2012,73663,25339,3807,20894,50040,0.6793098299010358
3816,Montenegro,MNE,2019,73066,25258,3790,21190,50238,0.68757014206334
3817,Montenegro,MNE,2014,73428,25281,3806,20942,50029,0.6813340959851828
3818,Montenegro,MNE,2015,73319,25255,3804,20965,50024,0.6822788090399488
3819,Montenegro,MNE,2016,73239,25208,3802,21047,50057,0.6834746514834992
3820,Montenegro,MNE,2017,73174,25167,3799,21138,50104,0.6847240823243228
3821,Montenegro,MNE,2018,73121,25189,3795,21185,50169,0.6861093256383255
3822,Montenegro,MNE,2006,74222,25278,3792,20691,49761,0.6704346420198863
3823,Montenegro,MNE,2013,73539,25313,3808,20909,50030,0.680319286365058
3824,Montenegro,MNE,2005,74257,25241,3786,20616,49643,0.6685295662361798
3825,Montenegro,MNE,2004,74255,25190,3779,20524,49493,0.6665275065652144
3826,Montenegro,MNE,2003,74225,25119,3771,20413,49303,0.6642371168743685
3827,Montenegro,MNE,1990,69574,23421,3529,18517,45467,0.6535056199154857
3828,Montenegro,MNE,1991,70210,23598,3553,18665,45816,0.6525566158666857
3829,Montenegro,MNE,1992,70826,23776,3577,18822,46175,0.6519498489255359
3830,Montenegro,MNE,1993,71388,23947,3599,18968,46514,0.6515660895388581
3831,Montenegro,MNE,1995,72311,24245,3641,19263,47149,0.6520308113565018
3832,Montenegro,MNE,1996,72698,24377,3661,19411,47449,0.6526864562986602
3833,Montenegro,MNE,1994,71881,24104,3621,19111,46836,0.6515769118404029
3834,Montenegro,MNE,1998,73401,24629,3698,19724,48051,0.6546368578084767
3835,Montenegro,MNE,1999,73658,24742,3715,19868,48325,0.6560726601319612
3836,Montenegro,MNE,2000,73875,24843,3731,20014,48588,0.6577055837563451
3837,Montenegro,MNE,2001,74042,24936,3746,20153,48835,0.6595580886523865
3838,Montenegro,MNE,2002,74166,25031,3759,20289,49079,0.6617452741148235
3839,Montenegro,MNE,1997,73066,24506,3680,19568,47754,0.6535734815098678
3840,Morocco,MAR,2011,5138175,1613823,254038,1679890,3547751,0.6904690867866509
3841,Morocco,MAR,2007,4926190,1537281,239300,1569863,3346444,0.6793168757193694
3842,Morocco,MAR,2008,4980009,1556683,243118,1596603,3396404,0.6820076027975049
3843,Morocco,MAR,2009,5033198,1575709,246844,1624463,3447016,0.6848560299038504
3844,Morocco,MAR,2010,5085690,1594307,250497,1652166,3496970,0.6876097442038347
3845,Morocco,MAR,2012,5192187,1635184,257528,1707408,3600120,0.6933725615044296
3846,Morocco,MAR,2019,5552161,1781634,281077,1889974,3952685,0.7119182963174159
3847,Morocco,MAR,2014,5296414,1678378,264332,1760462,3703172,0.6991847691664587
3848,Morocco,MAR,2015,5347382,1697895,267734,1786998,3752627,0.7017690151928552
3849,Morocco,MAR,2016,5394940,1712974,271081,1812835,3796890,0.7037872524995644
3850,Morocco,MAR,2017,5441736,1727936,274425,1838421,3840782,0.7058008694284323
3851,Morocco,MAR,2018,5493386,1750970,277754,1863906,3892630,0.7086030364514709
3852,Morocco,MAR,2006,4870028,1517538,235387,1541705,3294630,0.6765115108167756
3853,Morocco,MAR,2013,5244292,1657103,260950,1734248,3652301,0.6964335700605535
3854,Morocco,MAR,2005,4812549,1497507,231396,1514327,3243230,0.673911060438034
3855,Morocco,MAR,2004,4751455,1476444,227319,1486865,3190628,0.671505465168038
3856,Morocco,MAR,2003,4688237,1454008,223210,1459986,3137204,0.6691649760880263
3857,Morocco,MAR,1991,3834145,1159803,173343,1131549,2464695,0.6428278012438235
3858,Morocco,MAR,1992,3912675,1186631,177621,1160396,2524648,0.645248583130467
3859,Morocco,MAR,1993,3987465,1212737,181842,1188699,2583278,0.6478496989942232
3860,Morocco,MAR,1994,4062531,1238161,186017,1216633,2640811,0.6500408243038638
3861,Morocco,MAR,1995,4135389,1262907,190142,1244544,2697593,0.6523190442301801
3862,Morocco,MAR,1996,4208814,1287200,194245,1272812,2754257,0.6544021665010619
3863,Morocco,MAR,1990,3754416,1132474,168999,1102256,2403729,0.6402404528427323
3864,Morocco,MAR,1998,4348825,1335770,202414,1324955,2863139,0.6583707093295316
3865,Morocco,MAR,1999,4417815,1359713,206525,1351330,2917568,0.6604097274331315
3866,Morocco,MAR,2000,4486857,1383332,210686,1377803,2971821,0.6623391385105432
3867,Morocco,MAR,2001,4555407,1406881,214871,1405791,3027543,0.6646042823396461
3868,Morocco,MAR,2002,4622338,1430638,219055,1432800,3082493,0.6668688010266666
3869,Morocco,MAR,1997,4279172,1311554,198327,1298641,2808522,0.6563237000055151
3870,Mozambique,MOZ,2008,2393539,702834,96021,724338,1523193,0.6363769297262338
3871,Mozambique,MOZ,2009,2453503,722841,98651,743629,1565121,0.637912812823135
3872,Mozambique,MOZ,2010,2516173,743696,101348,763638,1608682,0.6393368023581845
3873,Mozambique,MOZ,2011,2580952,766017,104116,783499,1653632,0.6407062200304384
3874,Mozambique,MOZ,2012,2649170,790304,107011,804920,1702235,0.6425540829769324
3875,Mozambique,MOZ,2013,2720184,816160,110069,827331,1753560,0.6446475679586381
3876,Mozambique,MOZ,2016,2951349,899729,120362,900707,1920798,0.6508203536755565
3877,Mozambique,MOZ,2015,2871775,870304,116718,875876,1862898,0.6486921851468168
3878,Mozambique,MOZ,2017,3036926,930451,124229,927945,1982625,0.6528394172264981
3879,Mozambique,MOZ,2018,3130952,960786,128274,959466,2048526,0.6542821480495389
3880,Mozambique,MOZ,2019,3233504,991537,132497,995930,2119964,0.6556243629202252
3881,Mozambique,MOZ,2007,2336043,683876,93515,705758,1483149,0.6348979877510816
3882,Mozambique,MOZ,2014,2794622,843016,113297,851304,1807617,0.6468198561379679
3883,Mozambique,MOZ,2006,2283135,666053,91175,688629,1445857,0.6332770510723195
3884,Mozambique,MOZ,2005,2231479,649135,88972,672117,1410224,0.6319683044294838
3885,Mozambique,MOZ,1990,1532125,430150,58651,444443,933244,0.6091174023007261
3886,Mozambique,MOZ,1991,1533226,430353,58689,445825,934867,0.6097385512638058
3887,Mozambique,MOZ,1992,1561853,438402,59874,454698,952974,0.6101560134020295
3888,Mozambique,MOZ,1993,1646950,462715,63426,478721,1004862,0.6101350982118462
3889,Mozambique,MOZ,1994,1748962,491928,67697,507354,1066979,0.6100641409018607
3890,Mozambique,MOZ,1995,1819335,512006,70618,527925,1110549,0.6104147944166413
3891,Mozambique,MOZ,1996,1861157,524439,72410,541498,1138347,0.611634053440951
3892,Mozambique,MOZ,2004,2181972,632640,86846,655728,1375214,0.6302619831968513
3893,Mozambique,MOZ,1998,1930676,547478,75660,567791,1190929,0.6168456022657349
3894,Mozambique,MOZ,1999,1966326,559791,77356,581244,1218391,0.6196281796609514
3895,Mozambique,MOZ,2000,2004294,572752,79107,594850,1246709,0.6220190251529966
3896,Mozambique,MOZ,2001,2045597,586441,80919,609300,1276660,0.6241014236919589
3897,Mozambique,MOZ,2002,2088537,601054,82813,624045,1307912,0.6262335788161761
3898,Mozambique,MOZ,2003,2133910,616522,84788,639593,1340903,0.6283784227076118
3899,Mozambique,MOZ,1997,1895760,535668,74007,554200,1163875,0.6139358357598008
3900,Myanmar,MMR,2007,5461695,1846498,150149,962998,2959645,0.5418912993127591
3901,Myanmar,MMR,2008,5465918,1873475,152072,974334,2999881,0.548833882981779
3902,Myanmar,MMR,2009,5472729,1900540,154009,986553,3041102,0.555682914319346
3903,Myanmar,MMR,2010,5492498,1928987,156208,1002864,3088059,0.5622321573899526
3904,Myanmar,MMR,2011,5519099,1956805,158426,1022771,3138002,0.5685714280537457
3905,Myanmar,MMR,2012,5548144,1985410,160672,1047310,3193392,0.5755784276687844
3906,Myanmar,MMR,2016,5700987,2103900,169940,1139352,3413192,0.5987019440668783
3907,Myanmar,MMR,2014,5618087,2043511,165261,1099199,3307971,0.5888073644996954
3908,Myanmar,MMR,2015,5660119,2072181,167604,1121772,3361557,0.593902177675063
3909,Myanmar,MMR,2017,5743203,2135907,172266,1155541,3463714,0.6030979577075719
3910,Myanmar,MMR,2018,5794620,2167301,174594,1179630,3521525,0.6077231984150816
3911,Myanmar,MMR,2019,5854019,2201417,176927,1208782,3587126,0.6127629582343344
3912,Myanmar,MMR,2006,5450291,1818433,148022,949791,2916246,0.5350624397853252
3913,Myanmar,MMR,2013,5583611,2014449,162952,1073982,3251383,0.5823082947576398
3914,Myanmar,MMR,2004,5418808,1769749,143801,919973,2833523,0.522905221960254
3915,Myanmar,MMR,2000,5329129,1678105,135196,857414,2670715,0.5011541285639736
3916,Myanmar,MMR,2003,5402124,1747291,141684,903901,2792876,0.5169959075356286
3917,Myanmar,MMR,1990,4734357,1403181,112829,731380,2247390,0.4746980424163197
3918,Myanmar,MMR,1991,4815963,1431330,115086,745045,2291461,0.47580535813917174
3919,Myanmar,MMR,1992,4893185,1459502,117338,757942,2334782,0.47714975011163485
3920,Myanmar,MMR,1993,4969656,1487543,119587,771249,2378379,0.4785802075636624
3921,Myanmar,MMR,2005,5436265,1792967,145910,935107,2873984,0.5286688562827603
3922,Myanmar,MMR,1995,5112584,1542342,124078,798430,2464850,0.48211432809710314
3923,Myanmar,MMR,1994,5041683,1515246,121838,784724,2421808,0.48035705537218426
3924,Myanmar,MMR,1997,5221625,1597604,128562,821828,2547994,0.48796954970914225
3925,Myanmar,MMR,1998,5260392,1625466,130789,832191,2588446,0.49206332912071954
3926,Myanmar,MMR,1999,5295653,1652528,132999,843645,2629172,0.49647739381715533
3927,Myanmar,MMR,2001,5360013,1702013,137376,872769,2712158,0.5059983996307471
3928,Myanmar,MMR,2002,5384083,1724891,139539,888325,2752755,0.5112764792073228
3929,Myanmar,MMR,1996,5173140,1569663,126323,810550,2506536,0.48452893213792786
3930,Namibia,NAM,2011,210584,70071,10737,61886,142694,0.677610834631311
3931,Namibia,NAM,2007,198297,64989,9951,58171,133111,0.671270871470572
3932,Namibia,NAM,2008,200999,66242,10143,58753,135138,0.6723317031428017
3933,Namibia,NAM,2009,203915,67524,10339,59516,137379,0.6737071819140328
3934,Namibia,NAM,2010,206963,68783,10537,60445,139765,0.6753139450046627
3935,Namibia,NAM,2012,214572,71453,10942,63651,146046,0.6806386667412337
3936,Namibia,NAM,2006,195618,63824,9770,57536,131130,0.6703370855442751
3937,Namibia,NAM,2014,223220,74320,11356,67522,153198,0.6863094704775557
3938,Namibia,NAM,2015,227288,75717,11562,69144,156423,0.6882149519552286
3939,Namibia,NAM,2016,231105,77111,11767,70453,159331,0.6894312109214427
3940,Namibia,NAM,2017,234908,78441,11974,71783,162198,0.6904745687673473
3941,Namibia,NAM,2018,238696,79453,12184,73316,164953,0.6910589201327211
3942,Namibia,NAM,2019,242536,80117,12400,75143,167660,0.6912788204637662
3943,Namibia,NAM,2013,218927,72885,11149,65638,149672,0.6836616771800645
3944,Namibia,NAM,2005,192993,62780,9599,56776,129155,0.6692211634618872
3945,Namibia,NAM,1990,132936,42730,6467,38882,88079,0.6625669495095384
3946,Namibia,NAM,2003,187437,60877,9273,55022,125172,0.6678083836168953
3947,Namibia,NAM,1991,137487,44170,6687,40375,91232,0.6635681919017798
3948,Namibia,NAM,1992,142184,45661,6914,41886,94461,0.6643574523153097
3949,Namibia,NAM,1993,146910,47190,7147,43416,97753,0.6653937785038458
3950,Namibia,NAM,1994,151747,48740,7384,44949,101073,0.6660625910232163
3951,Namibia,NAM,1995,156504,50294,7621,46435,104350,0.6667561212492972
3952,Namibia,NAM,1996,161206,51839,7856,47822,107517,0.6669540835949034
3953,Namibia,NAM,2004,190216,61823,9435,55914,127172,0.6685662615132271
3954,Namibia,NAM,1998,169759,54846,8312,49995,113153,0.6665508161570226
3955,Namibia,NAM,1999,173715,56259,8527,50972,115758,0.6663673257922459
3956,Namibia,NAM,2000,177613,57583,8732,52009,118324,0.6661899748329233
3957,Namibia,NAM,2001,181227,58792,8924,53078,120794,0.666534236068577
3958,Namibia,NAM,2002,184490,59882,9104,54086,123072,0.6670930673749255
3959,Namibia,NAM,1997,165609,53365,8087,48965,110417,0.6667330881775749
3960,Nauru,NRU,2008,1118,377,23,268,668,0.5974955277280859
3961,Nauru,NRU,2009,1118,378,23,268,669,0.5983899821109123
3962,Nauru,NRU,2010,1117,378,23,267,668,0.5980304386750224
3963,Nauru,NRU,2011,1116,379,23,267,669,0.5994623655913979
3964,Nauru,NRU,2012,1113,381,23,268,672,0.6037735849056604
3965,Nauru,NRU,2013,1110,383,23,268,674,0.6072072072072072
3966,Nauru,NRU,2016,1108,389,24,272,685,0.618231046931408
3967,Nauru,NRU,2015,1108,387,24,271,682,0.6155234657039711
3968,Nauru,NRU,2017,1111,391,24,274,689,0.6201620162016201
3969,Nauru,NRU,2018,1116,394,24,277,695,0.6227598566308243
3970,Nauru,NRU,2019,1124,399,24,280,703,0.6254448398576512
3971,Nauru,NRU,2007,1119,376,23,269,668,0.5969615728328865
3972,Nauru,NRU,2014,1108,385,23,269,677,0.6110108303249098
3973,Nauru,NRU,2006,1121,376,24,269,669,0.5967885816235504
3974,Nauru,NRU,2005,1123,377,24,269,670,0.5966162065894924
3975,Nauru,NRU,1990,994,348,21,243,612,0.6156941649899397
3976,Nauru,NRU,2004,1124,378,24,270,672,0.597864768683274
3977,Nauru,NRU,1991,1003,351,21,245,617,0.6151545363908275
3978,Nauru,NRU,1992,1014,354,22,247,623,0.6143984220907298
3979,Nauru,NRU,1993,1025,357,22,249,628,0.6126829268292683
3980,Nauru,NRU,1995,1049,364,22,254,640,0.6101048617731173
3981,Nauru,NRU,1996,1061,367,23,257,647,0.6098020735155514
3982,Nauru,NRU,1994,1037,360,22,252,634,0.6113789778206364
3983,Nauru,NRU,1998,1086,374,23,261,658,0.6058931860036832
3984,Nauru,NRU,1999,1097,376,23,263,662,0.6034639927073838
3985,Nauru,NRU,2000,1106,379,23,265,667,0.6030741410488246
3986,Nauru,NRU,2001,1114,380,24,267,671,0.6023339317773788
3987,Nauru,NRU,2002,1120,380,24,268,672,0.6
3988,Nauru,NRU,2003,1123,379,24,269,672,0.5983971504897596
3989,Nauru,NRU,1997,1074,371,23,259,653,0.6080074487895717
3990,Nepal,NPL,2011,3608916,798582,97099,1206225,2101906,0.5824203167931866
3991,Nepal,NPL,2007,3388440,719849,89412,1092570,1901831,0.5612703781091003
3992,Nepal,NPL,2008,3448240,738564,91295,1125099,1954958,0.5669437162146487
3993,Nepal,NPL,2009,3506543,757851,93200,1157121,2008172,0.5726928202506001
3994,Nepal,NPL,2010,3562883,777438,95134,1186388,2058960,0.5778915557990537
3995,Nepal,NPL,2012,3642391,821909,99102,1214487,2135498,0.5862901594035347
3996,Nepal,NPL,2006,3328245,701938,87543,1061088,1850569,0.5560194637113554
3997,Nepal,NPL,2014,3703845,869517,103184,1222823,2195524,0.5927688658677671
3998,Nepal,NPL,2015,3745254,890515,105221,1239476,2235212,0.5968118584213514
3999,Nepal,NPL,2016,3793577,909897,107252,1264867,2282016,0.6015472995539566
4000,Nepal,NPL,2017,3845429,928371,109294,1293497,2331162,0.606216367536626
4001,Nepal,NPL,2018,3898205,946780,111323,1325121,2383224,0.6113644613354094
4002,Nepal,NPL,2019,3955151,966187,113333,1360059,2439579,0.6168105844757886
4003,Nepal,NPL,2013,3671935,846055,101134,1217405,2164594,0.5894968184349668
4004,Nepal,NPL,2005,3268893,685049,85678,1031502,1802229,0.5513270088681398
4005,Nepal,NPL,1990,2387995,472118,59722,660805,1192645,0.4994336252797849
4006,Nepal,NPL,2003,3151605,652322,81941,979363,1713626,0.5437312099707926
4007,Nepal,NPL,2004,3211417,668693,83812,1005150,1757655,0.547314472085064
4008,Nepal,NPL,1991,2426487,483027,61018,669372,1213417,0.5000715025466858
4009,Nepal,NPL,1992,2469470,494559,62406,681086,1238051,0.5013427982522566
4010,Nepal,NPL,1993,2516881,506666,63885,694701,1265252,0.50270632580563
4011,Nepal,NPL,1995,2620449,532401,67108,727697,1327206,0.5064803779810254
4012,Nepal,NPL,1996,2680936,546022,68839,752970,1367831,0.5102065099651764
4013,Nepal,NPL,1994,2566943,519298,65452,710427,1295177,0.504560093465262
4014,Nepal,NPL,1998,2826975,574896,72476,828886,1476258,0.5222041227814183
4015,Nepal,NPL,1999,2901342,589852,74356,868826,1533034,0.5283878977383569
4016,Nepal,NPL,2000,2969125,604932,76261,901282,1582475,0.5329768871300468
4017,Nepal,NPL,2001,3031245,620335,78173,927729,1626237,0.5364914416353677
4018,Nepal,NPL,2002,3092819,636163,80064,953683,1669910,0.5399313700543097
4019,Nepal,NPL,1997,2752091,560233,70633,788678,1419544,0.5158056183461956
4020,Netherlands,NLD,2011,2572915,1106329,146458,680215,1933002,0.7512887133854014
4021,Netherlands,NLD,2007,2502648,1052202,143349,670090,1865641,0.7454668015637836
4022,Netherlands,NLD,2008,2515427,1059743,144079,672986,1876808,0.7461190485750531
4023,Netherlands,NLD,2009,2530467,1070045,144844,676036,1890925,0.7472632521981121
4024,Netherlands,NLD,2010,2546995,1082212,145652,678444,1906308,0.7484537661047627
4025,Netherlands,NLD,2012,2609573,1145729,147259,680670,1973658,0.756314538815354
4026,Netherlands,NLD,2019,2732687,1236203,152491,713508,2102202,0.769280199305665
4027,Netherlands,NLD,2014,2685865,1227057,148920,682771,2058748,0.7665120920076027
4028,Netherlands,NLD,2015,2708020,1246558,149752,685726,2082036,0.7688407028013087
4029,Netherlands,NLD,2016,2709996,1235827,150559,695536,2081922,0.7682380342996816
4030,Netherlands,NLD,2017,2710051,1223348,151260,704663,2079271,0.767244232673112
4031,Netherlands,NLD,2018,2720074,1228079,151903,709075,2089057,0.7680147672453029
4032,Netherlands,NLD,2006,2492523,1047816,142648,666666,1857130,0.7450803864197041
4033,Netherlands,NLD,2013,2650307,1189619,148076,681273,2018968,0.7617864647378587
4034,Netherlands,NLD,2005,2484568,1046565,142003,663373,1851941,0.7453774660222622
4035,Netherlands,NLD,2004,2486331,1057437,141332,660245,1859014,0.7476936900195509
4036,Netherlands,NLD,2003,2497169,1082684,140604,656957,1880245,0.7529506413062151
4037,Netherlands,NLD,1991,2361743,1046764,132455,618712,1797931,0.7612729242766889
4038,Netherlands,NLD,1992,2393174,1076565,133243,620581,1830389,0.7648374083957121
4039,Netherlands,NLD,1993,2420409,1101768,133945,622581,1858294,0.7677603248046094
4040,Netherlands,NLD,1994,2443005,1120645,134596,624682,1879923,0.769512547047591
4041,Netherlands,NLD,1995,2460012,1131439,135209,627989,1894637,0.7701738853306407
4042,Netherlands,NLD,1996,2472919,1136823,135829,631457,1904109,0.7699843787847479
4043,Netherlands,NLD,1990,2327909,1014513,131603,616627,1762743,0.757221609607592
4044,Netherlands,NLD,1998,2495422,1143185,137021,637772,1917978,0.7685986578622774
4045,Netherlands,NLD,1999,2505663,1144858,137632,640851,1923341,0.7675976378307857
4046,Netherlands,NLD,2000,2516676,1146060,138288,644953,1929301,0.7666068258289903
4047,Netherlands,NLD,2001,2519844,1136800,139017,649142,1924959,0.7639199093277202
4048,Netherlands,NLD,2002,2510834,1112423,139822,653096,1905341,0.7588478569272202
4049,Netherlands,NLD,1997,2484408,1140601,136430,634656,1911687,0.76947385453597
4050,New Zealand,NZL,2007,726190,318070,65298,159323,542691,0.7473126867624176
4051,New Zealand,NZL,2008,730197,318402,65983,160462,544847,0.7461643912533193
4052,New Zealand,NZL,2009,733258,318649,66556,161292,546497,0.7452997444282913
4053,New Zealand,NZL,2010,736645,319690,67040,162077,548807,0.7450087898512853
4054,New Zealand,NZL,2011,740429,321277,67453,163154,551884,0.745357083528603
4055,New Zealand,NZL,2012,743985,322610,67777,164417,554804,0.7457193357392958
4056,New Zealand,NZL,2015,754676,326519,68651,168086,563256,0.7463547270616795
4057,New Zealand,NZL,2014,751300,325191,68361,167023,560575,0.746140023958472
4058,New Zealand,NZL,2016,757811,327833,68922,168778,565533,0.7462718276720712
4059,New Zealand,NZL,2017,760608,329115,69155,169400,567670,0.7463371408136649
4060,New Zealand,NZL,2018,764175,330376,69380,170086,569842,0.7456956848889326
4061,New Zealand,NZL,2006,720477,316767,64485,157759,539011,0.748130752265513
4062,New Zealand,NZL,2013,747733,323892,68075,165722,557689,0.74583975830945
4063,New Zealand,NZL,2005,711444,313444,63507,155304,532255,0.7481333738143832
4064,New Zealand,NZL,2019,768276,331593,69600,170727,571920,0.7444199740718179
4065,New Zealand,NZL,2003,688523,304244,61185,149675,515104,0.7481289659168975
4066,New Zealand,NZL,1990,587396,249927,53548,129823,433298,0.7376590919924548
4067,New Zealand,NZL,1991,596427,257236,54019,131670,442925,0.7426306991467523
4068,New Zealand,NZL,1992,606117,264604,54577,133644,452825,0.7470917331142337
4069,New Zealand,NZL,1993,615907,271534,55173,135476,462183,0.7504103703968293
4070,New Zealand,NZL,1994,625338,277514,55782,137210,470506,0.752402700619505
4071,New Zealand,NZL,1995,633545,281978,56379,138786,477143,0.7531319795752472
4072,New Zealand,NZL,2004,700229,308873,62396,152498,523767,0.7479938705766257
4073,New Zealand,NZL,1997,644928,287070,57274,140550,484894,0.751857571697926
4074,New Zealand,NZL,1998,649350,288850,57622,141073,487545,0.7508200508200508
4075,New Zealand,NZL,1999,654165,290759,57991,141807,490557,0.7498979615234689
4076,New Zealand,NZL,2000,659974,293133,58432,143070,494635,0.7494764945285723
4077,New Zealand,NZL,2001,667614,296132,59083,144850,500065,0.7490331239308942
4078,New Zealand,NZL,2002,677239,299892,60033,147085,507010,0.7486426505266235
4079,New Zealand,NZL,1996,640043,284972,56889,139914,481775,0.7527228639325795
4080,Nicaragua,NIC,2006,659606,218657,42767,156188,417612,0.633123410035688
4081,Nicaragua,NIC,2007,670827,223359,43791,159265,426415,0.6356556906624211
4082,Nicaragua,NIC,2008,681864,228073,44808,162184,435065,0.6380524562082761
4083,Nicaragua,NIC,2009,692834,232801,45821,165012,443634,0.6403178827828888
4084,Nicaragua,NIC,2010,704368,237542,46833,168127,452502,0.642422710855689
4085,Nicaragua,NIC,2011,716198,242479,47838,171622,461939,0.6449878385586109
4086,Nicaragua,NIC,2015,764409,263545,51748,185428,500721,0.6550433079673317
4087,Nicaragua,NIC,2013,740326,253084,49813,178439,481336,0.6501676288553961
4088,Nicaragua,NIC,2014,752239,258414,50781,181778,490973,0.6526821927605455
4089,Nicaragua,NIC,2016,777203,268692,52705,189305,510702,0.657102455857736
4090,Nicaragua,NIC,2017,789363,273699,53656,193138,520493,0.6593835789110967
4091,Nicaragua,NIC,2018,800986,278394,54604,196804,529802,0.661437278554182
4092,Nicaragua,NIC,2005,647864,214052,41748,152713,408513,0.6305536347134584
4093,Nicaragua,NIC,2012,728272,247717,48834,175006,471557,0.6475012083397412
4094,Nicaragua,NIC,2019,811879,283013,55552,200158,538723,0.6635508493260696
4095,Nicaragua,NIC,2004,635679,209461,40738,148884,399083,0.6278058579880726
4096,Nicaragua,NIC,2002,610260,199989,38725,141187,379901,0.6225231868383968
4097,Nicaragua,NIC,2003,623158,204758,39731,145057,389546,0.6251159417033882
4098,Nicaragua,NIC,1990,428425,140203,26186,90110,256499,0.5987022232596138
4099,Nicaragua,NIC,1991,445761,145477,27222,94423,267122,0.5992493735432216
4100,Nicaragua,NIC,1992,463047,150767,28275,98789,277831,0.6000060469023663
4101,Nicaragua,NIC,1994,496547,161329,30419,107642,299390,0.6029439307860082
4102,Nicaragua,NIC,1995,512459,166502,31493,111935,309930,0.6047898466023623
4103,Nicaragua,NIC,1993,479928,156059,29342,103197,288598,0.6013360337383941
4104,Nicaragua,NIC,1997,542358,176374,33600,120542,330516,0.6094055955660284
4105,Nicaragua,NIC,1998,556452,181103,34633,124894,340630,0.6121462408258035
4106,Nicaragua,NIC,1999,570187,185764,35660,129161,350585,0.6148596863835899
4107,Nicaragua,NIC,2000,583756,190457,36691,133248,360396,0.6173743824474609
4108,Nicaragua,NIC,2001,597000,195200,37712,137282,370194,0.6200904522613065
4109,Nicaragua,NIC,1996,527554,171502,32551,116166,320219,0.606988099796419
4110,Niger,NER,2011,1576769,406166,64391,437768,908325,0.5760672615963404
4111,Niger,NER,2007,1347982,344503,56033,382278,782814,0.5807303064877721
4112,Niger,NER,2008,1402296,358369,57946,394930,811245,0.578511954680039
4113,Niger,NER,2009,1458404,373169,59976,408168,841313,0.5768723892693657
4114,Niger,NER,2010,1516787,388882,62111,422767,873760,0.5760597895419726
4115,Niger,NER,2012,1640342,425390,66804,453861,946055,0.5767425329595901
4116,Niger,NER,2006,1297112,331515,54220,370124,755859,0.5827245449891759
4117,Niger,NER,2014,1775795,467963,72083,489038,1029084,0.5795060803752685
4118,Niger,NER,2015,1847192,490165,74940,508372,1073477,0.5811399139883672
4119,Niger,NER,2016,1920772,513631,77981,529150,1120762,0.5834955944797197
4120,Niger,NER,2017,1997807,537346,81193,551037,1169576,0.585429923911569
4121,Niger,NER,2018,2077860,559827,84596,574990,1219413,0.586860038693656
4122,Niger,NER,2013,1706540,446156,69366,470899,986421,0.5780239549029029
4123,Niger,NER,2005,1248862,319403,52480,358331,730214,0.5847035140792177
4124,Niger,NER,2019,2161851,581725,88182,601439,1271346,0.588082157373473
4125,Niger,NER,2003,1160994,297188,49191,335844,682223,0.5876197465275445
4126,Niger,NER,1990,729457,190202,31123,212677,434002,0.5949658444569043
4127,Niger,NER,1991,755405,196693,32213,219791,448697,0.5939820361263164
4128,Niger,NER,1992,782743,203444,33373,227351,464168,0.5930017898595069
4129,Niger,NER,1993,810668,210461,34596,235388,480445,0.592653219320363
4130,Niger,NER,1994,840058,217742,35892,243957,497591,0.5923293391646767
4131,Niger,NER,1995,870364,225233,37246,253047,515526,0.5923108032960922
4132,Niger,NER,2004,1203658,308024,50813,346881,705718,0.5863110617800072
4133,Niger,NER,1997,935074,241304,40075,272423,553802,0.592254730641639
4134,Niger,NER,1998,969920,249870,41537,282736,574143,0.5919488205212801
4135,Niger,NER,1999,1006072,258723,43032,293401,595156,0.591564023250821
4136,Niger,NER,2000,1042868,267760,44547,303851,616158,0.5908302872463246
4137,Niger,NER,2001,1080799,277106,46077,314432,637615,0.5899478071315758
4138,Niger,NER,2002,1120250,286899,47618,325170,659687,0.5888748047310868
4139,Niger,NER,1996,901399,233076,38641,262342,534059,0.5924779148856388
4140,Nigeria,NGA,2007,14957933,4100835,675048,5064261,9840144,0.6578545311039968
4141,Nigeria,NGA,2009,15649400,4542102,713382,5052023,10307507,0.6586518971973366
4142,Nigeria,NGA,2010,15976405,4708195,733224,5057928,10499347,0.6571783201540021
4143,Nigeria,NGA,2011,16259038,4814965,753752,5058756,10627473,0.653634796843454
4144,Nigeria,NGA,2012,16496746,4891448,774989,5030816,10697253,0.648446245095851
4145,Nigeria,NGA,2015,17466663,5162940,845434,5113425,11121799,0.6367443512249592
4146,Nigeria,NGA,2014,17040003,5040003,820649,5018471,10879123,0.6384460730435317
4147,Nigeria,NGA,2006,14587866,3897167,656212,5024143,9577522,0.6565403054840235
4148,Nigeria,NGA,2016,17999625,5324264,871735,5272723,11468722,0.6371644964825656
4149,Nigeria,NGA,2017,18563673,5495328,899449,5444529,11839306,0.6377674288919009
4150,Nigeria,NGA,2018,19142371,5670137,928628,5620481,12219246,0.6383350317471123
4151,Nigeria,NGA,2019,19735093,5848988,959300,5800001,12608289,0.6388765940956043
4152,Nigeria,NGA,2013,16737789,4958566,797225,5004947,10760738,0.6429008036844054
4153,Nigeria,NGA,2005,14200375,3746308,637328,4920595,9304231,0.6552102321241516
4154,Nigeria,NGA,2008,15310833,4327140,694046,5064701,10085887,0.6587418855655992
4155,Nigeria,NGA,2003,13410812,3524974,600135,4637157,8762266,0.6533732633042653
4156,Nigeria,NGA,1990,8591056,2378315,400287,2778789,5557391,0.6468810120665026
4157,Nigeria,NGA,1991,8847399,2448871,412248,2844699,5705818,0.6449147370882674
4158,Nigeria,NGA,1992,9120800,2522807,424843,2919235,5866885,0.6432423690904306
4159,Nigeria,NGA,1993,9410133,2600184,438055,3001812,6040051,0.6418666983771643
4160,Nigeria,NGA,1994,9713718,2680952,451879,3091083,6223914,0.6407344746882707
4161,Nigeria,NGA,1995,10030082,2764855,466337,3185805,6416997,0.6397751284585709
4162,Nigeria,NGA,2004,13803964,3633542,618603,4778216,9030361,0.6541860729280372
4163,Nigeria,NGA,1997,10847270,2939369,496847,3547615,6983831,0.6438330566124011
4164,Nigeria,NGA,1998,11331785,3029360,512905,3798591,7340856,0.647811090662239
4165,Nigeria,NGA,1999,11812858,3121822,529474,4040311,7691607,0.6511215998702431
4166,Nigeria,NGA,2000,12242012,3218011,546583,4222952,7987546,0.6524700351543521
4167,Nigeria,NGA,2001,12630277,3317801,564114,4359209,8241124,0.6524895693103168
4168,Nigeria,NGA,2002,13019377,3419917,581961,4497169,8499047,0.6527998229101132
4169,Nigeria,NGA,1996,10400509,2851288,481329,3330223,6662840,0.6406263385763139
4170,Niue,NIU,2006,185,65,5,53,123,0.6648648648648648
4171,Niue,NIU,2007,183,65,5,53,123,0.6721311475409836
4172,Niue,NIU,2008,183,65,5,53,123,0.6721311475409836
4173,Niue,NIU,2009,183,65,5,53,123,0.6721311475409836
4174,Niue,NIU,2010,184,66,5,53,124,0.6739130434782609
4175,Niue,NIU,2011,185,66,5,54,125,0.6756756756756757
4176,Niue,NIU,2015,190,68,5,55,128,0.6736842105263158
4177,Niue,NIU,2013,187,67,5,54,126,0.6737967914438503
4178,Niue,NIU,2014,189,68,5,55,128,0.6772486772486772
4179,Niue,NIU,2016,191,69,5,56,130,0.680628272251309
4180,Niue,NIU,2017,192,69,5,56,130,0.6770833333333334
4181,Niue,NIU,2018,193,70,5,57,132,0.6839378238341969
4182,Niue,NIU,2005,189,67,5,54,126,0.6666666666666666
4183,Niue,NIU,2012,186,67,5,54,126,0.6774193548387096
4184,Niue,NIU,2019,194,70,5,57,132,0.6804123711340206
4185,Niue,NIU,2004,193,68,5,55,128,0.6632124352331606
4186,Niue,NIU,2002,205,73,5,58,136,0.6634146341463415
4187,Niue,NIU,1990,250,87,6,65,158,0.632
4188,Niue,NIU,1991,249,87,6,65,158,0.6345381526104418
4189,Niue,NIU,1992,248,87,6,66,159,0.6411290322580645
4190,Niue,NIU,1993,247,87,6,66,159,0.6437246963562753
4191,Niue,NIU,1994,246,86,6,66,158,0.6422764227642277
4192,Niue,NIU,1995,245,86,6,66,158,0.6448979591836734
4193,Niue,NIU,2003,199,70,5,56,131,0.6582914572864321
4194,Niue,NIU,1997,238,84,6,65,155,0.6512605042016807
4195,Niue,NIU,1998,233,82,6,64,152,0.6523605150214592
4196,Niue,NIU,1999,226,80,5,62,147,0.6504424778761062
4197,Niue,NIU,2000,219,77,5,61,143,0.6529680365296804
4198,Niue,NIU,2001,212,75,5,59,139,0.6556603773584906
4199,Niue,NIU,1996,242,85,6,66,157,0.6487603305785123
4200,North America (WB),,2006,53562240,20512020,2198682,15418938,38129640,0.711875380865326
4201,North America (WB),,2007,54022442,20596591,2222083,15569672,38388346,0.710599976209887
4202,North America (WB),,2008,54509664,20714849,2244369,15708698,38667916,0.7093772583151494
4203,North America (WB),,2009,54956564,20812033,2266296,15842059,38920388,0.7082027180593022
4204,North America (WB),,2010,55272973,20819524,2287276,15966494,39073294,0.7069150052775341
4205,North America (WB),,2011,55366668,20628827,2307486,16062518,38998831,0.704373812056019
4206,North America (WB),,2014,54940762,19504756,2360989,16168142,38033887,0.6922708316277084
4207,North America (WB),,2013,55055720,19828452,2343699,16140254,38312405,0.6958841878736669
4208,North America (WB),,2015,55032852,19424352,2377376,16210388,38012116,0.6907168103880933
4209,North America (WB),,2016,55359846,19539753,2392682,16286100,38218535,0.6903656307136403
4210,North America (WB),,2017,55727611,19688330,2406552,16377422,38472304,0.6903634178755662
4211,North America (WB),,2005,53193876,20513687,2174314,15254653,37942654,0.7132898907385504
4212,North America (WB),,2019,58020510,21954511,2433618,16574815,40962944,0.7060079961379174
4213,North America (WB),,2012,55245111,20252064,2326146,16112156,38690366,0.7003400898226089
4214,North America (WB),,2018,56563258,20448244,2420172,16470978,39339394,0.6954937779574154
4215,North America (WB),,2004,53000366,20692629,2148578,15105918,37947125,0.7159785462613598
4216,North America (WB),,2002,52845671,21315039,2095154,14867992,38278185,0.724339085409664
4217,North America (WB),,2003,52915873,21001005,2121556,14982043,38104604,0.720097805057473
4218,North America (WB),,1990,42078145,15546969,1850744,11341571,28739284,0.6829978840559631
4219,North America (WB),,1991,42905306,15727680,1866480,11774821,29368981,0.6845069698372505
4220,North America (WB),,1992,43732408,15918953,1883447,12201799,30004199,0.6860861400543048
4221,North America (WB),,1994,45334448,16334786,1919570,13003256,31257612,0.6894891937362951
4222,North America (WB),,1995,46093362,16565525,1938977,13368203,31872705,0.6914814545313488
4223,North America (WB),,1993,44542119,16119557,1901160,12612530,30633247,0.6877366341731519
4224,North America (WB),,1997,48496005,18317370,1979747,13947806,34244923,0.7061390520724335
4225,North America (WB),,1998,49991311,19643061,2001124,14171511,35815696,0.7164384226690914
4226,North America (WB),,1999,51332258,20805116,2023151,14374647,37202914,0.7247472729526139
4227,North America (WB),,2000,52221824,21430657,2045606,14565969,38042232,0.7284738273408451
4228,North America (WB),,2001,52650809,21500291,2069644,14736434,38306369,0.7275551834350732
4229,North America (WB),,1996,47109954,17177564,1959086,13686571,32823221,0.6967364264460967
4230,North Korea,PRK,2011,2939416,955380,50853,758105,1764338,0.6002341961804658
4231,North Korea,PRK,2007,2850742,925521,48317,726584,1700422,0.5964840031121722
4232,North Korea,PRK,2008,2873870,933556,48997,733589,1716142,0.5971536638748447
4233,North Korea,PRK,2009,2895475,940938,49649,740782,1731369,0.5979568119220507
4234,North Korea,PRK,2010,2916548,947966,50269,748958,1747193,0.5990619732642837
4235,North Korea,PRK,2012,2961487,963090,51409,767698,1782197,0.6017912622949214
4236,North Korea,PRK,2006,2825129,916444,47621,719381,1683446,0.5958828782685676
4237,North Korea,PRK,2014,3005314,977510,52465,786608,1816583,0.6044569718838032
4238,North Korea,PRK,2015,3024745,982994,52963,795739,1831696,0.6055703869251788
4239,North Korea,PRK,2016,3037925,982779,53430,803583,1839792,0.6056081042158711
4240,North Korea,PRK,2017,3049707,982222,53869,810977,1847068,0.6056542480966204
4241,North Korea,PRK,2018,3067579,988138,54289,820236,1862663,0.6072094638801478
4242,North Korea,PRK,2013,2984271,970644,51948,777341,1799933,0.6031399293160709
4243,North Korea,PRK,2005,2795094,905947,46912,711007,1663866,0.5952808742747113
4244,North Korea,PRK,2019,3090229,998016,54685,831412,1884113,0.6097001225475523
4245,North Korea,PRK,2003,2727274,881461,45481,691828,1618770,0.5935487230105959
4246,North Korea,PRK,1990,2215922,732502,37265,570224,1339991,0.60471036435398
4247,North Korea,PRK,1991,2257431,743465,38014,581987,1363466,0.6039901108826804
4248,North Korea,PRK,1992,2299890,754791,38750,593472,1387013,0.603077973294375
4249,North Korea,PRK,1993,2342495,766416,39471,604392,1410279,0.6020414131086725
4250,North Korea,PRK,1994,2386865,778337,40177,615414,1433928,0.6007578979121149
4251,North Korea,PRK,1995,2427035,788959,40788,624478,1454225,0.5991775973564452
4252,North Korea,PRK,2004,2762653,894143,46196,701388,1641727,0.5942574040243201
4253,North Korea,PRK,1997,2510872,811733,41975,642623,1496331,0.5959407727673892
4254,North Korea,PRK,1998,2554270,824243,42581,651692,1518516,0.5945009728807057
4255,North Korea,PRK,1999,2595444,836746,43178,660852,1540776,0.5936464050081605
4256,North Korea,PRK,2000,2632349,848255,43744,668855,1560854,0.5929510106752562
4257,North Korea,PRK,2001,2664055,858964,44287,676058,1579309,0.5928214695267178
4258,North Korea,PRK,2002,2694487,869664,44842,683533,1598039,0.5930772722228759
4259,North Korea,PRK,1996,2467058,799545,41360,633461,1474366,0.5976211341606075
4260,North Macedonia,MKD,2007,243353,83275,12955,62632,158862,0.6528047733128418
4261,North Macedonia,MKD,2008,243759,83776,13053,62933,159762,0.6554096464130555
4262,North Macedonia,MKD,2009,244046,84186,13135,63240,160561,0.6579128524950214
4263,North Macedonia,MKD,2010,244397,84540,13209,63646,161395,0.660380446568493
4264,North Macedonia,MKD,2011,244958,84904,13286,64114,162304,0.6625788910752047
4265,North Macedonia,MKD,2012,245661,85297,13361,64632,163290,0.6646964719674674
4266,North Macedonia,MKD,2015,246881,86048,13487,65962,165497,0.6703513028544117
4267,North Macedonia,MKD,2014,246194,85752,13439,65473,164664,0.6688383957366955
4268,North Macedonia,MKD,2016,247470,86173,13541,66418,166132,0.6713217763769346
4269,North Macedonia,MKD,2017,247777,86184,13570,66840,166594,0.672354576897775
4270,North Macedonia,MKD,2018,248228,86357,13586,67294,167237,0.6737233511126868
4271,North Macedonia,MKD,2006,242785,82714,12847,62281,157842,0.6501307741417304
4272,North Macedonia,MKD,2013,245994,85564,13410,65108,164082,0.6670162686894803
4273,North Macedonia,MKD,2005,241904,82145,12734,61881,156760,0.6480256630729545
4274,North Macedonia,MKD,2019,248755,86616,13590,67860,168066,0.6756286305802899
4275,North Macedonia,MKD,2003,240051,80907,12521,61043,154471,0.6434924245264548
4276,North Macedonia,MKD,1990,223384,73697,11363,55532,140592,0.6293736346381119
4277,North Macedonia,MKD,1991,224613,74104,11425,55898,141427,0.6296474380378696
4278,North Macedonia,MKD,1992,225461,74406,11468,56175,142049,0.6300380110085558
4279,North Macedonia,MKD,1993,225477,74463,11470,56290,142223,0.630765000421329
4280,North Macedonia,MKD,1994,225503,74536,11476,56453,142465,0.6317654310585669
4281,North Macedonia,MKD,1995,226388,74914,11534,56821,143269,0.6328471473753026
4282,North Macedonia,MKD,2004,241036,81587,12634,61452,155673,0.6458495826349591
4283,North Macedonia,MKD,1997,236799,78515,12140,59344,149999,0.6334443979915456
4284,North Macedonia,MKD,1998,246411,81760,12696,61572,156028,0.6332022515228622
4285,North Macedonia,MKD,1999,238852,79504,12310,60143,151957,0.6361973104684072
4286,North Macedonia,MKD,2000,230446,76941,11868,58558,147367,0.639486040113519
4287,North Macedonia,MKD,2001,233628,78194,12078,59377,149649,0.6405439416508295
4288,North Macedonia,MKD,2002,238111,79939,12366,60492,152797,0.6417049191343533
4289,North Macedonia,MKD,1996,228143,75587,11645,57356,144588,0.6337604046584817
4290,Northern Ireland,,2006,312914,143049,21701,88300,253050,0.8086886492774372
4291,Northern Ireland,,2007,315392,144103,21906,89286,255295,0.8094529981737013
4292,Northern Ireland,,2008,317758,145131,22106,90204,257441,0.8101794447346723
4293,Northern Ireland,,2009,320048,146120,22301,91093,259514,0.8108596210568415
4294,Northern Ireland,,2010,322278,147013,22488,91931,261432,0.8112002680915235
4295,Northern Ireland,,2011,322636,145699,22665,92727,261091,0.8092432338610694
4296,Northern Ireland,,2015,314076,129407,23303,95020,247730,0.7887581349737006
4297,Northern Ireland,,2013,317181,135882,23005,94090,252977,0.7975793001472345
4298,Northern Ireland,,2014,314575,131242,23162,94623,249027,0.7916299769530318
4299,Northern Ireland,,2016,313665,129760,23431,93380,246571,0.7860966317568107
4300,Northern Ireland,,2017,313483,130341,23554,91850,245745,0.7839181072019854
4301,Northern Ireland,,2018,315183,131017,23672,92371,247060,0.7838620737793599
4302,Northern Ireland,,2005,310527,142013,21498,87311,250822,0.8077300846625253
4303,Northern Ireland,,2012,320399,141354,22840,93432,257626,0.8040786644153072
4304,Northern Ireland,,2019,317029,131726,23787,93118,248631,0.7842531755769977
4305,Northern Ireland,,2004,308195,140956,21287,86394,248637,0.8067522185629228
4306,Northern Ireland,,2002,303191,138651,20836,84470,243957,0.8046314039664766
4307,Northern Ireland,,2003,305756,139840,21064,85445,246349,0.8057045487251272
4308,Northern Ireland,,1990,243756,90968,18757,71929,181654,0.7452288353927699
4309,Northern Ireland,,1991,245414,91582,18912,72295,182789,0.7448189589835951
4310,Northern Ireland,,1992,247268,92281,19062,72784,184127,0.7446454858695828
4311,Northern Ireland,,1994,251300,93923,19379,74088,187390,0.7456824512534819
4312,Northern Ireland,,1995,253517,94862,19550,74840,189252,0.7465061514612432
4313,Northern Ireland,,1993,249259,93065,19216,73424,185705,0.7450282637738256
4314,Northern Ireland,,1997,269600,109313,19886,77628,206827,0.7671624629080118
4315,Northern Ireland,,1998,281615,120986,20058,79474,220518,0.7830477779947801
4316,Northern Ireland,,1999,292108,131073,20234,81199,232506,0.7959590288523423
4317,Northern Ireland,,2000,297995,136090,20416,82522,239028,0.8021208409537073
4318,Northern Ireland,,2001,300601,137385,20615,83506,241506,0.8034105009630707
4319,Northern Ireland,,1996,259219,99493,19719,75990,195202,0.7530389361890911
4320,Northern Mariana Islands,MNP,2011,5828,2151,159,1548,3858,0.6619766643788607
4321,Northern Mariana Islands,MNP,2007,6388,2352,175,1668,4195,0.6567000626174077
4322,Northern Mariana Islands,MNP,2008,6310,2326,173,1653,4152,0.6580031695721078
4323,Northern Mariana Islands,MNP,2009,6177,2278,169,1625,4072,0.659219685931682
4324,Northern Mariana Islands,MNP,2010,6004,2214,164,1587,3965,0.6603930712858095
4325,Northern Mariana Islands,MNP,2012,5665,2098,154,1511,3763,0.6642541924095322
4326,Northern Mariana Islands,MNP,2006,6434,2365,176,1672,4213,0.6548026111283805
4327,Northern Mariana Islands,MNP,2014,5422,2025,148,1466,3639,0.6711545555145703
4328,Northern Mariana Islands,MNP,2015,5330,1998,147,1456,3601,0.675609756097561
4329,Northern Mariana Islands,MNP,2016,5233,1966,146,1446,3558,0.679915918211351
4330,Northern Mariana Islands,MNP,2017,5135,1930,144,1434,3508,0.6831548198636807
4331,Northern Mariana Islands,MNP,2018,5040,1897,142,1422,3461,0.6867063492063492
4332,Northern Mariana Islands,MNP,2013,5531,2056,151,1483,3690,0.6671487976857711
4333,Northern Mariana Islands,MNP,2005,6489,2385,178,1679,4242,0.6537216828478964
4334,Northern Mariana Islands,MNP,2019,4952,1867,140,1413,3420,0.6906300484652665
4335,Northern Mariana Islands,MNP,2003,6910,2569,192,1781,4542,0.6573082489146165
4336,Northern Mariana Islands,MNP,1990,4707,1743,129,1172,3044,0.6466964096027193
4337,Northern Mariana Islands,MNP,1991,4898,1819,136,1227,3182,0.6496529195590037
4338,Northern Mariana Islands,MNP,1992,4908,1821,136,1230,3187,0.6493480032599837
4339,Northern Mariana Islands,MNP,1993,4835,1789,133,1207,3129,0.6471561530506722
4340,Northern Mariana Islands,MNP,1994,4814,1777,132,1197,3106,0.6452014956377233
4341,Northern Mariana Islands,MNP,1995,4949,1827,135,1228,3190,0.6445746615477874
4342,Northern Mariana Islands,MNP,2004,6627,2445,183,1710,4338,0.6545948392937981
4343,Northern Mariana Islands,MNP,1997,5822,2178,161,1459,3798,0.6523531432497424
4344,Northern Mariana Islands,MNP,1998,6488,2455,181,1637,4273,0.6586004932182491
4345,Northern Mariana Islands,MNP,1999,7168,2741,202,1822,4765,0.6647600446428571
4346,Northern Mariana Islands,MNP,2000,7651,2935,217,1961,5113,0.6682786563847863
4347,Northern Mariana Islands,MNP,2001,7672,2925,218,1975,5118,0.6671011470281544
4348,Northern Mariana Islands,MNP,2002,7324,2758,206,1888,4852,0.6624795193883124
4349,Northern Mariana Islands,MNP,1996,5293,1963,145,1318,3426,0.6472699792178349
4350,Norway,NOR,2007,719881,335856,43317,165639,544812,0.7568084169466898
4351,Norway,NOR,2009,733755,343954,44486,166639,555079,0.7564909268079945
4352,Norway,NOR,2010,742569,348460,45144,168258,561862,0.7566461837216474
4353,Norway,NOR,2011,752409,352762,45828,170817,569407,0.7567785605966968
4354,Norway,NOR,2012,762505,356612,46520,173824,576956,0.7566586448613452
4355,Norway,NOR,2015,792517,367510,48430,183744,599684,0.7566828219457753
4356,Norway,NOR,2014,782757,363755,47825,180420,592000,0.7563011253811847
4357,Norway,NOR,2006,713927,332360,42822,165214,540396,0.7569345325222326
4358,Norway,NOR,2016,802927,370670,48989,188876,608535,0.7578957987463368
4359,Norway,NOR,2017,812386,373629,49500,193402,616531,0.758913866068593
4360,Norway,NOR,2018,818913,377200,49968,195097,622265,0.759867043263448
4361,Norway,NOR,2019,823389,381121,50416,195502,627039,0.7615343416052437
4362,Norway,NOR,2013,772655,360181,47190,177075,584446,0.7564126291811999
4363,Norway,NOR,2005,707951,329273,42397,164145,535815,0.7568532285426534
4364,Norway,NOR,2008,726321,339732,43873,165914,549519,0.7565787028049581
4365,Norway,NOR,2003,691481,321863,41749,157293,520905,0.7533178785823471
4366,Norway,NOR,1990,658088,320988,39469,140139,500596,0.7606824619199863
4367,Norway,NOR,1991,660313,321736,39618,142616,503970,0.7632289535417295
4368,Norway,NOR,1992,662345,322352,39749,144608,506709,0.7650227600419721
4369,Norway,NOR,1993,664330,322938,39874,146139,508951,0.7661117215841524
4370,Norway,NOR,1994,666419,323578,40013,147300,510891,0.7666212998128805
4371,Norway,NOR,1995,668705,324334,40167,148153,512654,0.7666370073500273
4372,Norway,NOR,2004,700529,325876,42041,161462,529379,0.7556846326133536
4373,Norway,NOR,1997,667776,319518,40477,147437,507432,0.7598835537665325
4374,Norway,NOR,1998,665693,315076,40653,146494,502223,0.7544363542954485
4375,Norway,NOR,1999,664971,311823,40851,145946,498620,0.7498372109460413
4376,Norway,NOR,2000,667409,311572,41072,146454,499098,0.7478143087671877
4377,Norway,NOR,2001,673566,314150,41289,148776,504215,0.7485754922309024
4378,Norway,NOR,2002,682048,317774,41508,152738,512020,0.7507096274748991
4379,Norway,NOR,1996,669353,323227,40317,148192,511736,0.7645233531484882
4380,OECD Countries,,2006,172770664,62039536,10190739,49079753,121310028,0.70214482708708
4381,OECD Countries,,2007,174208547,62614733,10269659,49603614,122488006,0.7031113461958901
4382,OECD Countries,,2008,175698532,63247175,10344667,50143007,123734849,0.704245206784084
4383,OECD Countries,,2009,177068329,63804954,10417025,50657896,124879875,0.7052637572470681
4384,OECD Countries,,2010,178157190,64147745,10489403,51108788,125745936,0.7058145450093819
4385,OECD Countries,,2011,178899477,64198143,10561736,51464714,126224593,0.705561553989339
4386,OECD Countries,,2015,181024048,63922419,10838037,52454668,127215124,0.7027526199171062
4387,OECD Countries,,2013,179829499,63872733,10703153,51949055,126524941,0.7035827920534884
4388,OECD Countries,,2014,180331083,63784335,10772235,52179432,126736002,0.702796211787848
4389,OECD Countries,,2016,181765885,64139431,10900009,52709171,127748611,0.7028195142339279
4390,OECD Countries,,2017,182510175,64381326,10956688,52964356,128302370,0.7029874909713938
4391,OECD Countries,,2018,183757892,65255050,11006822,53316193,129578065,0.705156462069123
4392,OECD Countries,,2005,171527223,61641967,10106037,48593544,120341548,0.7015886218830698
4393,OECD Countries,,2012,179399937,64057458,10632567,51729262,126419287,0.7046785473508834
4394,OECD Countries,,2019,185539467,66798944,11051829,53733253,131584026,0.7091969602348809
4395,OECD Countries,,2004,170523409,61473155,10007360,48168735,119649250,0.7016587968869423
4396,OECD Countries,,2002,168687061,61368958,9782587,47402374,118553919,0.7028038682824642
4397,OECD Countries,,1990,149225681,52304089,8768064,40590775,101662928,0.6812696535792656
4398,OECD Countries,,1991,150578379,52701247,8851118,41109716,102662081,0.681785005800866
4399,OECD Countries,,1992,151944694,53104709,8934985,41655899,103695593,0.6824561639513388
4400,OECD Countries,,1993,153301067,53505426,9017645,42216490,104739561,0.6832278669006263
4401,OECD Countries,,1994,154646711,53905988,9099482,42794873,105800343,0.6841422123746298
4402,OECD Countries,,1995,155981108,54311512,9180439,43387401,106879352,0.6852070316105204
4403,OECD Countries,,2003,169598949,61419712,9896186,47780520,119096418,0.7022237973892161
4404,OECD Countries,,1997,159934775,56610292,9339261,44661233,110610786,0.6915993472964213
4405,OECD Countries,,1998,162369969,58307630,9419054,45314623,113041307,0.6961959018419225
4406,OECD Countries,,1999,164650491,59844631,9499615,45942040,115286286,0.7001879271650638
4407,OECD Countries,,2000,166403918,60809699,9581867,46506002,116897568,0.702492882409175
4408,OECD Countries,,2001,167652274,61202922,9675317,46988603,117866842,0.7030435030067054
4409,OECD Countries,,1996,157690971,55151512,9260153,44007880,108419545,0.6875444060776315
4410,Oman,OMN,2007,338697,123537,17675,93994,235206,0.6944437063215795
4411,Oman,OMN,2008,350109,127543,18476,97885,243904,0.6966516142115741
4412,Oman,OMN,2009,358827,130695,19116,101113,250924,0.6992896298216132
4413,Oman,OMN,2010,380306,137413,20577,108659,266649,0.701143289877099
4414,Oman,OMN,2011,429078,152426,23786,124914,301126,0.7017978083238945
4415,Oman,OMN,2012,491181,171775,27797,145282,344854,0.7020914896952447
4416,Oman,OMN,2015,565774,197343,32060,169087,398490,0.7043271695058451
4417,Oman,OMN,2014,543006,189710,30770,161823,382303,0.7040493106890163
4418,Oman,OMN,2016,599649,207467,34128,179617,421212,0.7024309220894223
4419,Oman,OMN,2017,617816,212890,35236,185429,433555,0.701754243982027
4420,Oman,OMN,2018,621616,215091,35222,186745,437058,0.703099662814342
4421,Oman,OMN,2006,323344,118607,16628,88902,224137,0.6931843485575734
4422,Oman,OMN,2013,526055,183522,29909,156549,369980,0.7033104903479674
4423,Oman,OMN,2019,632990,219926,35566,190946,446438,0.705284443672096
4424,Oman,OMN,2005,314812,115802,16004,85713,217519,0.6909488837782549
4425,Oman,OMN,2003,319067,116082,16102,86116,218300,0.6841823190740502
4426,Oman,OMN,2004,316290,115883,15992,85521,217396,0.6873312466407411
4427,Oman,OMN,1990,238790,82580,11302,61355,155237,0.650098412831358
4428,Oman,OMN,1991,246342,85359,11703,63394,160456,0.651354620811717
4429,Oman,OMN,1992,254963,88453,12175,65736,166364,0.6525025199734863
4430,Oman,OMN,1994,266867,93465,12743,68479,174687,0.6545844933993338
4431,Oman,OMN,1995,271336,95738,13007,69797,178542,0.6580107320812572
4432,Oman,OMN,1993,262160,91216,12529,67428,171173,0.6529333231614282
4433,Oman,OMN,1997,287173,101962,14016,75133,191111,0.6654908365340753
4434,Oman,OMN,1998,293911,104841,14369,77024,196234,0.6676647012190765
4435,Oman,OMN,1999,296073,106455,14496,77767,198718,0.6711790673246125
4436,Oman,OMN,2000,297825,107776,14696,78872,201344,0.6760480147737765
4437,Oman,OMN,2001,304224,110289,15169,81378,206836,0.6798806142842116
4438,Oman,OMN,2002,313847,113814,15779,84549,214142,0.6823133565081074
4439,Oman,OMN,1996,278279,98587,13469,72260,184316,0.662342469248488
4440,Pakistan,PAK,2011,20371866,5282045,583344,5229687,11095076,0.5446273797402752
4441,Pakistan,PAK,2007,18180723,4679958,519760,4769686,9969404,0.5483502498773014
4442,Pakistan,PAK,2008,18695964,4822359,534740,4864494,10221593,0.5467272508654809
4443,Pakistan,PAK,2009,19233083,4969920,550330,4968372,10488622,0.5453427305440318
4444,Pakistan,PAK,2010,19786764,5121734,566523,5088099,10776356,0.5446244772515607
4445,Pakistan,PAK,2012,20986866,5453594,600809,5389444,11443847,0.5452861327651304
4446,Pakistan,PAK,2006,17680230,4543589,505406,4670851,9719846,0.5497578934210697
4447,Pakistan,PAK,2014,22255898,5815533,637715,5740650,12193898,0.5478951242497607
4448,Pakistan,PAK,2015,22892311,5997212,657086,5920806,12575104,0.5493156195545308
4449,Pakistan,PAK,2016,23525435,6179019,677038,6097400,12953457,0.5506149833148675
4450,Pakistan,PAK,2017,24174203,6363478,697551,6287003,13348032,0.5521601684241668
4451,Pakistan,PAK,2018,24899035,6556281,718648,6546119,13821048,0.5550836809539004
4452,Pakistan,PAK,2019,25722001,6760231,740273,6886762,14387266,0.5593369660470816
4453,Pakistan,PAK,2013,21614294,5632805,618945,5559863,11811613,0.5464723020793555
4454,Pakistan,PAK,2005,17192286,4414804,491758,4561246,9467808,0.5507009364548728
4455,Pakistan,PAK,2004,16715545,4289488,478642,4444487,9212617,0.5511406896993188
4456,Pakistan,PAK,2003,16246410,4165203,465885,4330347,8961435,0.5515947830936189
4457,Pakistan,PAK,1991,12066679,3059334,343413,3259222,6661969,0.552096314155701
4458,Pakistan,PAK,1992,12321141,3135003,351928,3311431,6798362,0.551763996532464
4459,Pakistan,PAK,1993,12586982,3212546,360660,3370079,6943285,0.5516242892855492
4460,Pakistan,PAK,1994,12867425,3291886,369636,3435908,7097430,0.5515812215730809
4461,Pakistan,PAK,1995,13163035,3373082,378873,3509119,7261074,0.5516261257377193
4462,Pakistan,PAK,1996,13479329,3456653,388421,3594425,7439499,0.5519190903345411
4463,Pakistan,PAK,1990,11826142,2985594,335143,3212977,6533714,0.5524805976454537
4464,Pakistan,PAK,1998,14186580,3633684,408565,3795014,7837263,0.5524420261965886
4465,Pakistan,PAK,1999,14568216,3727979,419195,3901598,8048772,0.5524885133498845
4466,Pakistan,PAK,2000,14958904,3826511,430229,4005902,8262642,0.5523561084421693
4467,Pakistan,PAK,2001,15368752,3931823,441688,4110868,8484379,0.5520538687851818
4468,Pakistan,PAK,2002,15798134,4045283,453570,4219042,8717895,0.5518306782307328
4469,Pakistan,PAK,1997,13822417,3543354,398321,3691352,7633027,0.5522208597816142
4470,Palau,PLW,2007,2275,797,58,662,1517,0.6668131868131868
4471,Palau,PLW,2008,2232,785,57,653,1495,0.6698028673835126
4472,Palau,PLW,2009,2189,772,56,643,1471,0.6719963453631795
4473,Palau,PLW,2010,2147,758,55,633,1446,0.6734979040521658
4474,Palau,PLW,2011,2113,747,55,625,1427,0.6753431140558448
4475,Palau,PLW,2012,2092,740,54,621,1415,0.6763862332695985
4476,Palau,PLW,2015,2112,748,55,635,1438,0.6808712121212122
4477,Palau,PLW,2014,2099,743,55,628,1426,0.6793711291090996
4478,Palau,PLW,2016,2123,751,56,641,1448,0.682053697597739
4479,Palau,PLW,2017,2132,754,56,647,1457,0.6833958724202627
4480,Palau,PLW,2018,2144,759,56,653,1468,0.6847014925373134
4481,Palau,PLW,2006,2310,807,59,670,1536,0.6649350649350649
4482,Palau,PLW,2013,2090,740,54,623,1417,0.6779904306220096
4483,Palau,PLW,2005,2335,814,60,674,1548,0.6629550321199144
4484,Palau,PLW,2019,2156,766,57,660,1483,0.687847866419295
4485,Palau,PLW,2003,2333,809,60,668,1537,0.6588084012001715
4486,Palau,PLW,1990,1686,595,40,449,1084,0.6429418742586003
4487,Palau,PLW,1991,1736,613,42,468,1123,0.646889400921659
4488,Palau,PLW,1992,1789,632,43,489,1164,0.650642817216322
4489,Palau,PLW,1993,1845,652,45,509,1206,0.6536585365853659
4490,Palau,PLW,1994,1903,672,47,531,1250,0.6568575932737782
4491,Palau,PLW,1995,1962,691,49,551,1291,0.6580020387359837
4492,Palau,PLW,2004,2341,814,60,673,1547,0.6608287056813328
4493,Palau,PLW,1997,2077,727,52,587,1366,0.6576793452094367
4494,Palau,PLW,1998,2134,744,54,604,1402,0.6569821930646673
4495,Palau,PLW,1999,2189,761,55,620,1436,0.6560073092736409
4496,Palau,PLW,2000,2239,777,57,635,1469,0.6560964716391247
4497,Palau,PLW,2001,2280,791,58,648,1497,0.656578947368421
4498,Palau,PLW,2002,2313,802,59,659,1520,0.6571552096843926
4499,Palau,PLW,1996,2020,709,50,569,1328,0.6574257425742575
4500,Palestine,PSE,2006,610601,189457,24442,200743,414642,0.6790719307698481
4501,Palestine,PSE,2007,631197,196281,25414,208424,430119,0.6814338471190452
4502,Palestine,PSE,2008,651037,202899,26365,215912,445176,0.683795237444262
4503,Palestine,PSE,2009,669852,209237,27289,223069,459595,0.6861142461319814
4504,Palestine,PSE,2010,688289,215488,28216,230177,473881,0.6884913168741619
4505,Palestine,PSE,2011,705532,221778,29143,236516,487437,0.690878656106314
4506,Palestine,PSE,2015,759879,246515,32653,250974,530142,0.697666338982917
4507,Palestine,PSE,2013,734496,234367,30928,245311,510606,0.6951787348059077
4508,Palestine,PSE,2014,747267,240548,31796,248349,520693,0.6967964596322332
4509,Palestine,PSE,2016,769820,252135,33507,250403,536045,0.6963251149619392
4510,Palestine,PSE,2017,781322,257696,34370,251605,543671,0.6958347518692677
4511,Palestine,PSE,2018,797886,263701,35242,258214,557157,0.6982914852497725
4512,Palestine,PSE,2005,589453,182590,23473,193035,399098,0.6770650077275033
4513,Palestine,PSE,2012,720715,228087,30047,241473,499607,0.6932102148560805
4514,Palestine,PSE,2019,815855,270158,36131,266103,572392,0.7015854532974609
4515,Palestine,PSE,2004,568073,175661,22513,185298,383472,0.6750400036615013
4516,Palestine,PSE,2002,525418,161897,20679,170400,352976,0.6718003570490543
4517,Palestine,PSE,2003,546689,168726,21579,177802,368107,0.673338955054885
4518,Palestine,PSE,1990,324612,98452,12558,93095,204105,0.6287660345273742
4519,Palestine,PSE,1991,336406,102335,13069,96527,211931,0.6299857909787578
4520,Palestine,PSE,1992,348829,106433,13601,100248,220282,0.6314899277296325
4521,Palestine,PSE,1994,375510,115290,14742,108562,238594,0.6353865409709462
4522,Palestine,PSE,1995,389875,120072,15356,113147,248575,0.6375761462007054
4523,Palestine,PSE,1993,361866,110743,14158,104256,229157,0.6332647996772286
4524,Palestine,PSE,1997,423686,130614,16689,127888,275191,0.6495163871357562
4525,Palestine,PSE,1998,443371,136418,17413,137784,291615,0.65772231381845
4526,Palestine,PSE,1999,463988,142522,18180,147765,308467,0.6648167625024786
4527,Palestine,PSE,2000,484363,148799,18981,156117,323897,0.6687071473254563
4528,Palestine,PSE,2001,504588,155239,19813,163176,338228,0.6703052787620791
4529,Palestine,PSE,1996,405732,125157,16005,119374,260536,0.6421381601648378
4530,Panama,PAN,2011,408016,127253,30385,102672,260310,0.6379896866789537
4531,Panama,PAN,2007,377949,116513,28079,94446,239038,0.6324609934144554
4532,Panama,PAN,2008,385299,119141,28646,96366,244153,0.6336715122541196
4533,Panama,PAN,2009,392726,121805,29217,98338,249360,0.6349465021414421
4534,Panama,PAN,2010,400208,124468,29795,100435,254698,0.6364140646863631
4535,Panama,PAN,2012,415868,130235,30976,104920,266131,0.6399410389835236
4536,Panama,PAN,2006,370703,113965,27513,92543,234021,0.6312897386856864
4537,Panama,PAN,2014,431900,136411,32152,109513,278076,0.6438434822875666
4538,Panama,PAN,2015,440937,139743,32828,112100,284671,0.6456047008983142
4539,Panama,PAN,2016,452481,143996,33700,115271,292967,0.6474680704825175
4540,Panama,PAN,2017,464656,148270,34606,118568,301444,0.6487465996349988
4541,Panama,PAN,2018,473940,151346,35311,121332,307989,0.6498480820357008
4542,Panama,PAN,2013,423899,133312,31562,107178,272052,0.6417849534912797
4543,Panama,PAN,2005,363343,111547,26950,90507,229004,0.6302694698948377
4544,Panama,PAN,2019,481582,153755,35893,123699,313347,0.650661777225893
4545,Panama,PAN,2003,348862,107000,25842,86253,219095,0.6280277014980136
4546,Panama,PAN,1990,264248,80257,19103,61503,160863,0.6087576821773486
4547,Panama,PAN,1991,270719,82344,19622,63210,165176,0.6101381875671822
4548,Panama,PAN,1992,277029,84411,20136,64956,169503,0.6118601301668778
4549,Panama,PAN,1993,283351,86455,20646,66680,173781,0.6133064644204538
4550,Panama,PAN,1994,289629,88478,21154,68451,178083,0.614865914670147
4551,Panama,PAN,1995,295897,90477,21660,70269,182406,0.6164509947718294
4552,Panama,PAN,2004,356066,109244,26392,88421,224057,0.6292569355119556
4553,Panama,PAN,1997,308452,94440,22673,74063,191176,0.6197917342082399
4554,Panama,PAN,1998,314745,96425,23183,76038,195646,0.6216016140049881
4555,Panama,PAN,1999,321174,98443,23700,78052,200195,0.6233225603566914
4556,Panama,PAN,2000,327745,100513,24224,80080,204817,0.6249279165204656
4557,Panama,PAN,2001,334592,102641,24758,82116,209515,0.6261805422723795
4558,Panama,PAN,2002,341742,104804,25297,84197,214298,0.6270753960590153
4559,Panama,PAN,1996,302174,92460,22165,72115,186740,0.6179883113702701
4560,Papua New Guinea,PNG,2007,763316,248217,15377,176259,439853,0.5762397224740474
4561,Papua New Guinea,PNG,2009,814411,267047,16523,188462,472032,0.5795992441163
4562,Papua New Guinea,PNG,2010,840460,276378,17120,194911,488409,0.5811210527568237
4563,Papua New Guinea,PNG,2011,866547,285621,17730,201689,505040,0.5828189353837703
4564,Papua New Guinea,PNG,2012,892528,294963,18345,208443,521751,0.5845766183245792
4565,Papua New Guinea,PNG,2015,971557,323394,20240,229896,573530,0.5903204855710987
4566,Papua New Guinea,PNG,2014,944664,313887,19601,222536,556024,0.5885944632165511
4567,Papua New Guinea,PNG,2006,738312,239290,14834,170477,424601,0.5750969779713725
4568,Papua New Guinea,PNG,2016,998144,332821,20884,237128,590833,0.5919316250961785
4569,Papua New Guinea,PNG,2017,1024837,342424,21529,244507,608460,0.5937139271903727
4570,Papua New Guinea,PNG,2018,1053706,352702,22180,251941,626823,0.5948746614330752
4571,Papua New Guinea,PNG,2019,1083820,363732,22838,259211,645781,0.5958378697569707
4572,Papua New Guinea,PNG,2013,918538,304392,18969,215476,538837,0.5866246143327767
4573,Papua New Guinea,PNG,2005,714370,231014,14310,164845,410169,0.574168848075927
4574,Papua New Guinea,PNG,2008,788558,257560,15941,182175,455676,0.5778598403668468
4575,Papua New Guinea,PNG,2003,667492,216363,13332,154017,383712,0.5748563278661017
4576,Papua New Guinea,PNG,1990,447830,143857,8867,104297,257021,0.5739253734676105
4577,Papua New Guinea,PNG,1991,460161,148158,9122,107338,264618,0.5750552524007901
4578,Papua New Guinea,PNG,1992,473034,152657,9388,110461,272506,0.5760812119213418
4579,Papua New Guinea,PNG,1993,486495,157346,9666,113670,280682,0.5769473478658568
4580,Papua New Guinea,PNG,1994,500666,162230,9955,117034,289219,0.5776685454973974
4581,Papua New Guinea,PNG,1995,515955,167315,10258,120541,298114,0.577790698801252
4582,Papua New Guinea,PNG,2004,690748,223446,13809,159308,396563,0.5741066206489197
4583,Papua New Guinea,PNG,1997,548593,178261,10915,127789,316965,0.5777780613314424
4584,Papua New Guinea,PNG,1998,565759,184113,11267,131504,326884,0.5777795845934399
4585,Papua New Guinea,PNG,1999,584109,190212,11636,135397,337245,0.5773665531604546
4586,Papua New Guinea,PNG,2000,603259,196579,12027,139694,348300,0.577363951470264
4587,Papua New Guinea,PNG,2001,623617,203054,12442,144282,359778,0.5769214116998094
4588,Papua New Guinea,PNG,2002,645105,209611,12876,149071,371558,0.5759651529595957
4589,Papua New Guinea,PNG,1996,531916,172639,10579,124132,307350,0.5778167981410599
4590,Paraguay,PRY,2006,825675,331385,59742,185671,576798,0.6985775274775184
4591,Paraguay,PRY,2007,842857,338806,61209,190487,590502,0.700595711965375
4592,Paraguay,PRY,2008,859716,346238,62669,195322,604229,0.7028239558179677
4593,Paraguay,PRY,2009,876505,353738,64115,200159,618012,0.7050866794827183
4594,Paraguay,PRY,2010,893500,361390,65548,205107,632045,0.7073810856183548
4595,Paraguay,PRY,2011,911348,369619,66960,210803,647382,0.7103565268152232
4596,Paraguay,PRY,2015,988399,406259,72436,237986,716681,0.7250928015912602
4597,Paraguay,PRY,2013,950542,388001,69735,225066,682802,0.7183291217010926
4598,Paraguay,PRY,2014,970035,397351,71093,232068,700512,0.7221512625833089
4599,Paraguay,PRY,2016,1005083,414991,73746,242633,731370,0.7276712470512385
4600,Paraguay,PRY,2017,1021294,423454,75038,246977,745469,0.7299259566784883
4601,Paraguay,PRY,2018,1037250,431573,76315,251031,758919,0.7316644974692698
4602,Paraguay,PRY,2005,808501,323936,58278,180970,563184,0.6965779881533851
4603,Paraguay,PRY,2012,930780,378631,68359,217705,664695,0.7141268613421001
4604,Paraguay,PRY,2019,1052887,439782,77584,254777,772143,0.7333579007053939
4605,Paraguay,PRY,2004,790708,316386,56813,175968,549167,0.6945256656060138
4606,Paraguay,PRY,2002,754563,301209,53911,165816,520936,0.6903810549947453
4607,Paraguay,PRY,1990,544031,214504,38251,116832,369587,0.6793491547356676
4608,Paraguay,PRY,1991,561899,221544,39416,121155,382115,0.6800421428050237
4609,Paraguay,PRY,1992,579724,228694,40613,125471,394778,0.6809757746789852
4610,Paraguay,PRY,1993,597670,235859,41832,129746,407437,0.6817089698328509
4611,Paraguay,PRY,1994,615562,243032,43078,134026,420136,0.6825242623813685
4612,Paraguay,PRY,1995,633278,250186,44350,138172,432708,0.6832828552389314
4613,Paraguay,PRY,2003,773044,308801,55358,171038,535197,0.6923241109173605
4614,Paraguay,PRY,1997,667782,264514,46963,145483,456960,0.6842951741736075
4615,Paraguay,PRY,1998,684545,271744,48309,148814,468867,0.6849323273123024
4616,Paraguay,PRY,1999,701447,279009,49679,152265,480953,0.6856583605033595
4617,Paraguay,PRY,2000,718655,286307,51070,156291,493668,0.6869332294355428
4618,Paraguay,PRY,2001,736458,293683,52479,160862,507024,0.6884628858672185
4619,Paraguay,PRY,1996,650630,257325,45643,142020,444988,0.6839340331678527
4620,Peru,PER,2006,3624767,1476930,249653,586902,2313485,0.6382437822900066
4621,Peru,PER,2007,3668611,1503289,254083,589414,2346786,0.6396933335259585
4622,Peru,PER,2008,3711203,1529613,258430,591232,2379275,0.6411061318930815
4623,Peru,PER,2009,3757206,1556643,262878,595058,2414579,0.6426528116903891
4624,Peru,PER,2010,3811179,1585538,267673,603793,2457004,0.644683443102515
4625,Peru,PER,2011,3879969,1619587,273160,618320,2511067,0.6471873873219091
4626,Peru,PER,2014,4179132,1761043,294986,681971,2738000,0.6551599710179051
4627,Peru,PER,2013,4076283,1712608,287514,659691,2659813,0.6525094062409308
4628,Peru,PER,2015,4263329,1800787,301272,700158,2802217,0.6572837798818717
4629,Peru,PER,2016,4333742,1832635,306808,715455,2854898,0.6587604892030952
4630,Peru,PER,2017,4418818,1870181,313439,733359,2916979,0.6601265315747333
4631,Peru,PER,2005,3576665,1451320,245187,580817,2277324,0.6367171652922485
4632,Peru,PER,2019,4535206,1924984,321921,762966,3009871,0.6636679789187084
4633,Peru,PER,2012,3966578,1661584,279659,636852,2578095,0.6499544443598487
4634,Peru,PER,2018,4485759,1900963,318426,749097,2968486,0.6617577984015637
4635,Peru,PER,2004,3525758,1426858,240695,571809,2239362,0.6351434216415307
4636,Peru,PER,2002,3423141,1379987,231758,552602,2164347,0.6322693105542542
4637,Peru,PER,2003,3475664,1403286,236214,562583,2202083,0.6335718872710365
4638,Peru,PER,1990,2742307,1075259,178479,430941,1684679,0.6143291031966881
4639,Peru,PER,1991,2803504,1099068,183002,441974,1724044,0.6149604209589142
4640,Peru,PER,1992,2863834,1123219,187526,452791,1763536,0.6157954685921041
4641,Peru,PER,1994,2982408,1172103,196445,473741,1842289,0.6177186354113857
4642,Peru,PER,1995,3040763,1196765,200839,484318,1881922,0.6188979542305665
4643,Peru,PER,1993,2923631,1147583,192012,463440,1803035,0.616710863990702
4644,Peru,PER,1997,3154491,1249984,209674,504542,1964200,0.6226678091647749
4645,Peru,PER,1998,3209203,1277865,214077,513812,2005754,0.6250006621581745
4646,Peru,PER,1999,3264138,1305463,218484,523080,2047027,0.6271263653681309
4647,Peru,PER,2000,3318206,1331735,222894,532732,2087361,0.6290631142249757
4648,Peru,PER,2001,3371898,1356298,227312,542638,2126248,0.6305789795539486
4649,Peru,PER,1996,3097282,1222611,205249,494691,1922551,0.6207219749444836
4650,Philippines,PHL,2011,10982056,4194674,305653,2371069,6871396,0.6256930396275524
4651,Philippines,PHL,2007,10200428,3823467,277617,2130701,6231785,0.610933678469178
4652,Philippines,PHL,2008,10400978,3919179,284582,2189613,6393374,0.6146896955267092
4653,Philippines,PHL,2009,10597468,4014096,291621,2249487,6555204,0.6185632266122436
4654,Philippines,PHL,2010,10790603,4105646,298670,2309667,6713983,0.6222064698330575
4655,Philippines,PHL,2012,11171557,4283775,312615,2435103,7031493,0.629410296165521
4656,Philippines,PHL,2006,9995802,3729976,270830,2074470,6075276,0.6077827471972734
4657,Philippines,PHL,2014,11545134,4461902,326606,2563746,7352254,0.6368270823015133
4658,Philippines,PHL,2015,11733041,4551257,333662,2624364,7509283,0.6400116559722241
4659,Philippines,PHL,2016,11919765,4641304,340728,2681047,7663079,0.6428884294279291
4660,Philippines,PHL,2017,12109063,4732203,347807,2739004,7819014,0.6457158576183806
4661,Philippines,PHL,2018,12316014,4828357,354897,2806369,7989623,0.6487182460169337
4662,Philippines,PHL,2013,11358795,4372719,319590,2499945,7192254,0.6331881154647125
4663,Philippines,PHL,2005,9789457,3641197,264192,2020998,5926387,0.6053846500372799
4664,Philippines,PHL,2019,12539270,4932222,362026,2884235,8178483,0.6522295955027685
4665,Philippines,PHL,2003,9379815,3475107,251285,1933025,5659417,0.6033612603233646
4666,Philippines,PHL,1990,7039588,2477922,177548,1530945,4186415,0.59469602482418
4667,Philippines,PHL,1991,7213738,2548573,182688,1567348,4298609,0.5958920326743222
4668,Philippines,PHL,1992,7390168,2621223,187997,1602905,4412125,0.5970263463564022
4669,Philippines,PHL,1993,7568085,2695305,193450,1637608,4526363,0.5980856451797251
4670,Philippines,PHL,1994,7747304,2770188,199000,1672006,4641194,0.5990721417411786
4671,Philippines,PHL,1995,7927305,2845293,204610,1706286,4756189,0.5999755276225653
4672,Philippines,PHL,2004,9583200,3556776,257659,1973479,5787914,0.6039646464646464
4673,Philippines,PHL,1997,8270052,2999583,215889,1755591,4971063,0.6010921092152746
4674,Philippines,PHL,1998,8437279,3079318,221591,1773862,5074771,0.6014700948018905
4675,Philippines,PHL,1999,8609693,3159686,227358,1795687,5182731,0.6019646693558063
4676,Philippines,PHL,2000,8792942,3239449,233195,1826853,5299497,0.6026989601432604
4677,Philippines,PHL,2001,8984829,3317735,239095,1862657,5419487,0.6031819859899392
4678,Philippines,PHL,2002,9180339,3395750,245102,1896978,5537830,0.6032271793013309
4679,Philippines,PHL,1996,8101821,2921382,210234,1734713,4866329,0.6006463238326297
4680,Poland,POL,2007,4047643,1341517,245379,978064,2564960,0.6336922500329204
4681,Poland,POL,2008,4047226,1345123,246169,981961,2573253,0.6358065993843685
4682,Poland,POL,2009,4046304,1348010,246802,985902,2580714,0.6377953806733255
4683,Poland,POL,2010,4044809,1350050,247274,989691,2587015,0.6395889150760888
4684,Poland,POL,2011,4042769,1351143,247562,993156,2591861,0.6411103379886409
4685,Poland,POL,2012,4038401,1351200,247642,995350,2594192,0.6423809819777679
4686,Poland,POL,2015,4025690,1348612,247002,1000648,2596262,0.6449234789564025
4687,Poland,POL,2014,4029785,1349640,247332,998999,2595971,0.644195906233211
4688,Poland,POL,2016,4017745,1342733,246525,1002246,2591504,0.6450145541840012
4689,Poland,POL,2017,4010522,1337078,245938,1004953,2587969,0.6452948020232777
4690,Poland,POL,2018,4031840,1337517,245260,1032710,2615487,0.6487080340489702
4691,Poland,POL,2006,4048697,1337558,244448,974199,2556205,0.6313648563970087
4692,Poland,POL,2013,4034127,1350539,247545,997146,2595230,0.6433188642796819
4693,Poland,POL,2005,4050547,1333622,243359,970585,2547566,0.6289436957526972
4694,Poland,POL,2019,4082487,1341093,244523,1090061,2675677,0.6554036791788926
4695,Poland,POL,2003,4075391,1326498,240773,985425,2552696,0.6263683656365733
4696,Poland,POL,1990,3957619,1238929,221042,927778,2387749,0.603329678779084
4697,Poland,POL,1991,3985686,1247657,222362,934893,2404912,0.6033872211709603
4698,Poland,POL,1992,4011014,1256026,223721,942009,2421756,0.6037765014033858
4699,Poland,POL,1993,4035413,1264544,225202,949801,2439547,0.6045346535782087
4700,Poland,POL,1994,4057084,1272836,226738,957767,2457341,0.6056914276362038
4701,Poland,POL,1995,4075525,1280472,228265,965653,2474390,0.6071340502143896
4702,Poland,POL,2004,4058985,1330071,242128,973736,2545935,0.627234394805598
4703,Poland,POL,1997,4098617,1294829,231468,983332,2509629,0.612311177160491
4704,Poland,POL,1998,4104392,1301638,233161,992956,2527755,0.615865882206183
4705,Poland,POL,1999,4107486,1307833,234814,1001838,2544485,0.6194750268168899
4706,Poland,POL,2000,4109794,1313345,236382,1009552,2559279,0.6227268325371053
4707,Poland,POL,2001,4106399,1318328,237892,1009415,2565635,0.624789505354935
4708,Poland,POL,2002,4093046,1322625,239341,999345,2561311,0.6257713692931866
4709,Poland,POL,1996,4089833,1287766,229838,974072,2491676,0.6092366118616579
4710,Portugal,PRT,2006,1988677,912526,107190,625094,1644810,0.827087556199423
4711,Portugal,PRT,2007,1994428,917065,107327,627446,1651838,0.8282264388586602
4712,Portugal,PRT,2008,2000326,921834,107423,629772,1659029,0.8293793111722789
4713,Portugal,PRT,2009,2005225,925662,107486,632007,1665155,0.8304080589460036
4714,Portugal,PRT,2010,2007196,927389,107523,633285,1668197,0.8311081727942862
4715,Portugal,PRT,2011,2000672,925971,107544,627501,1661016,0.830229043041538
4716,Portugal,PRT,2015,1937563,911062,107606,572563,1591231,0.8212538121341086
4717,Portugal,PRT,2013,1963488,917217,107585,594262,1619064,0.824585635359116
4718,Portugal,PRT,2014,1945983,913056,107591,578678,1599325,0.821859697643813
4719,Portugal,PRT,2016,1947797,915044,107594,583036,1605674,0.8243538726058208
4720,Portugal,PRT,2017,1959440,920018,107526,594562,1622106,0.8278416282203078
4721,Portugal,PRT,2018,1960612,921946,107423,597098,1626467,0.8295710727058694
4722,Portugal,PRT,2005,1983440,909287,107020,623007,1639314,0.8265004235066349
4723,Portugal,PRT,2012,1984299,921995,107566,612627,1642188,0.8275910031703891
4724,Portugal,PRT,2019,1960225,923601,107265,598389,1629255,0.8311571375734929
4725,Portugal,PRT,2004,1984174,906437,106834,627193,1640464,0.8267742647570223
4726,Portugal,PRT,2002,1997756,898369,106431,653183,1657983,0.8299226732393746
4727,Portugal,PRT,2003,1990632,902650,106656,639354,1648660,0.8282093325134932
4728,Portugal,PRT,1990,1848179,837366,97412,556435,1491213,0.8068552883676311
4729,Portugal,PRT,1991,1852122,843473,98090,556534,1498097,0.8088543843224151
4730,Portugal,PRT,1992,1858873,850006,98882,558637,1507525,0.8109887012184265
4731,Portugal,PRT,1994,1877544,862883,100592,566069,1529544,0.8146514808707546
4732,Portugal,PRT,1995,1887941,868453,101483,570998,1540934,0.8161981756845156
4733,Portugal,PRT,1993,1867581,856610,99731,561914,1518255,0.812952691208574
4734,Portugal,PRT,1997,1928534,877462,103234,605077,1585773,0.8222686247688659
4735,Portugal,PRT,1998,1955835,881638,104087,630375,1616100,0.826296696807246
4736,Portugal,PRT,1999,1980363,885693,104869,652148,1642710,0.8294994402541352
4737,Portugal,PRT,2000,1996879,889655,105569,664566,1659790,0.8311920752334018
4738,Portugal,PRT,2001,2001281,893889,106093,663490,1663472,0.8312036140851784
4739,Portugal,PRT,1996,1903998,873125,102363,582922,1558410,0.8184935068209105
4740,Puerto Rico,PRI,2011,523676,178663,38604,121703,338970,0.6472895454441295
4741,Puerto Rico,PRI,2007,532219,180031,38845,122944,341820,0.6422544103085384
4742,Puerto Rico,PRI,2008,529211,179268,38797,122029,340094,0.6426434824672956
4743,Puerto Rico,PRI,2009,526481,178665,38741,121335,338741,0.6434059348770421
4744,Puerto Rico,PRI,2010,524618,178474,38683,121197,338354,0.6449530896766791
4745,Puerto Rico,PRI,2012,523425,179024,38512,122463,339999,0.6495658403782777
4746,Puerto Rico,PRI,2006,534938,180668,38882,123753,343303,0.6417622229118141
4747,Puerto Rico,PRI,2014,523086,179696,38322,124251,342269,0.6543264396294299
4748,Puerto Rico,PRI,2015,522005,179705,38234,124848,342787,0.6566737866495531
4749,Puerto Rico,PRI,2016,519878,179148,38116,125215,342479,0.6587680186505296
4750,Puerto Rico,PRI,2017,510698,176304,37446,124220,337970,0.6617805434914568
4751,Puerto Rico,PRI,2018,502346,173781,36778,123801,334360,0.6655970187878474
4752,Puerto Rico,PRI,2013,523369,179424,38416,123358,341198,0.6519262699930641
4753,Puerto Rico,PRI,2005,536425,180886,38896,123921,343703,0.6407288996597846
4754,Puerto Rico,PRI,2019,500989,173398,36605,125191,335194,0.6690645902405042
4755,Puerto Rico,PRI,2003,536810,180432,38820,123199,342451,0.6379370727072894
4756,Puerto Rico,PRI,1990,493023,158632,34721,108510,301863,0.612269610139892
4757,Puerto Rico,PRI,1991,498767,161659,35179,110052,306890,0.6152973231990088
4758,Puerto Rico,PRI,1992,504471,164573,35644,111557,311774,0.6180216504021043
4759,Puerto Rico,PRI,1993,509999,167246,36093,113084,316423,0.6204384714479833
4760,Puerto Rico,PRI,1994,515054,169608,36520,114545,320673,0.6226007370100999
4761,Puerto Rico,PRI,1995,519498,171580,36925,115933,324438,0.624522134830163
4762,Puerto Rico,PRI,2004,536858,180724,38872,123634,343230,0.6393310707859434
4763,Puerto Rico,PRI,1997,526453,174808,37663,118366,330837,0.6284264692194745
4764,Puerto Rico,PRI,1998,529322,176225,37976,119312,333513,0.6300758328578824
4765,Puerto Rico,PRI,1999,531704,177482,38241,120153,335876,0.6316973353595233
4766,Puerto Rico,PRI,2000,533799,178571,38465,121050,338086,0.6333582490787731
4767,Puerto Rico,PRI,2001,535357,179385,38625,121927,339937,0.634972551026698
4768,Puerto Rico,PRI,2002,536347,179987,38739,122685,341411,0.6365487268503413
4769,Puerto Rico,PRI,1996,523245,173249,37306,117212,327767,0.6264121014056513
4770,Qatar,QAT,2007,158704,51186,10144,52842,114172,0.7194021574755519
4771,Qatar,QAT,2009,215767,68938,14060,71634,154632,0.7166619547938285
4772,Qatar,QAT,2010,247537,78787,16231,82119,177137,0.7155980722073871
4773,Qatar,QAT,2011,275880,87720,18154,91411,197285,0.7151116427432217
4774,Qatar,QAT,2012,299749,95434,19739,99106,214279,0.7148614340665023
4775,Qatar,QAT,2015,349103,112429,22905,114395,249729,0.7153447549863508
4776,Qatar,QAT,2014,334771,107433,22002,110003,239438,0.7152292163897112
4777,Qatar,QAT,2006,136767,44327,8640,45544,98511,0.7202834016977779
4778,Qatar,QAT,2016,363824,117291,23837,119013,260141,0.7150188002990457
4779,Qatar,QAT,2017,378654,122142,24780,123778,270700,0.7149006744943933
4780,Qatar,QAT,2018,394090,127310,25717,128950,281977,0.7155142226394986
4781,Qatar,QAT,2019,410136,132759,26642,134587,293988,0.7168061325999181
4782,Qatar,QAT,2013,318857,101911,20992,105073,227976,0.7149788149546662
4783,Qatar,QAT,2005,119417,38888,7456,39727,86071,0.7207600257919726
4784,Qatar,QAT,2008,185268,59483,11972,61599,133054,0.7181704341818339
4785,Qatar,QAT,2003,96845,31661,5924,32207,69792,0.7206567195002324
4786,Qatar,QAT,1990,59436,19320,3561,18972,41853,0.7041691903896629
4787,Qatar,QAT,1991,61532,19982,3681,19701,43364,0.7047389975947475
4788,Qatar,QAT,1992,63580,20628,3798,20420,44846,0.7053475935828877
4789,Qatar,QAT,1993,65556,21258,3915,21133,46306,0.7063579229971322
4790,Qatar,QAT,1994,67483,21881,4030,21841,47752,0.7076152512484626
4791,Qatar,QAT,1995,69426,22509,4145,22545,49199,0.7086538184541814
4792,Qatar,QAT,2004,106239,34716,6562,35320,76598,0.7209969973361948
4793,Qatar,QAT,1997,73340,23812,4381,24026,52219,0.7120125443141533
4794,Qatar,QAT,1998,75382,24505,4509,24828,53842,0.7142553925340267
4795,Qatar,QAT,1999,77745,25313,4661,25720,55694,0.7163676120650846
4796,Qatar,QAT,2000,80778,26329,4856,26812,57997,0.7179801431082721
4797,Qatar,QAT,2001,84705,27646,5114,28162,60922,0.7192255474883419
4798,Qatar,QAT,2002,89891,29376,5458,29890,64724,0.7200275889688623
4799,Qatar,QAT,1996,71370,23150,4261,23265,50676,0.7100462379150904
4800,Region of the Americas (WHO),,2006,133846094,53614749,7699004,34963167,96276920,0.7193106434618854
4801,Region of the Americas (WHO),,2007,135144377,54084897,7818252,35204675,97107824,0.7185487561942736
4802,Region of the Americas (WHO),,2008,136340190,54523879,7935446,35357289,97816614,0.717445193526575
4803,Region of the Americas (WHO),,2009,137524578,54959479,8051208,35534403,98545090,0.7165634785659913
4804,Region of the Americas (WHO),,2010,138769596,55403613,8164230,35842223,99410066,0.7163677697815017
4805,Region of the Americas (WHO),,2011,139765133,55473941,8275272,36240206,99989419,0.7154103234030479
4806,Region of the Americas (WHO),,2015,142100159,54004051,8699343,37678153,100381547,0.7064140371581147
4807,Region of the Americas (WHO),,2013,140642628,54338508,8492968,36962031,99793507,0.7095537705680528
4808,Region of the Americas (WHO),,2014,141142064,53874517,8598340,37315724,99788581,0.7070080893814902
4809,Region of the Americas (WHO),,2016,143619223,54761138,8792386,38051303,101604827,0.7074598015336707
4810,Region of the Americas (WHO),,2017,145151173,55557891,8880029,38444731,102882651,0.7087965524054015
4811,Region of the Americas (WHO),,2018,147015019,56799592,8966649,38865002,104631243,0.7117044483734005
4812,Region of the Americas (WHO),,2005,132351482,53086439,7578175,34536547,95201161,0.7193055911531085
4813,Region of the Americas (WHO),,2012,140285120,54998041,8384947,36607824,99990812,0.7127684817890878
4814,Region of the Americas (WHO),,2019,149499255,58782316,9052030,39299785,107134131,0.7166198319851159
4815,Region of the Americas (WHO),,2004,130692711,52477398,7451954,33993296,93922648,0.7186525344936796
4816,Region of the Americas (WHO),,2002,127028839,50927359,7187134,32907584,91022077,0.7165465552275102
4817,Region of the Americas (WHO),,1990,97184586,34849537,5779811,24196945,64826293,0.6670429506177039
4818,Region of the Americas (WHO),,1991,99175727,35551520,5887616,24930130,66369266,0.66920876718151
4819,Region of the Americas (WHO),,1992,101212519,36282669,5999037,25676031,67957737,0.6714360799576582
4820,Region of the Americas (WHO),,1993,103260330,37026458,6112757,26421035,69560250,0.6736396252074732
4821,Region of the Americas (WHO),,1994,105304018,37773666,6228139,27161544,71163349,0.6757894936164734
4822,Region of the Americas (WHO),,1995,107314830,38511676,6345003,27885767,72742446,0.6778415061553003
4823,Region of the Americas (WHO),,2003,128914755,51761003,7319871,33451552,92532426,0.71777994691143
4824,Region of the Americas (WHO),,1997,113082231,42017931,6579906,29452537,78050374,0.6902090037470167
4825,Region of the Americas (WHO),,1998,116643321,44589148,6697731,30275693,81562572,0.6992476834571608
4826,Region of the Americas (WHO),,1999,120052982,47031727,6815524,31060140,84907391,0.7072493293002917
4827,Region of the Americas (WHO),,2000,122809151,48797850,6933797,31742894,87474541,0.7122803169610707
4828,Region of the Americas (WHO),,2001,124999733,49948457,7057225,32342019,89347701,0.7147831347767759
4829,Region of the Americas (WHO),,1996,109825503,39829459,6462252,28642851,74934562,0.682305657184197
4830,Romania,ROU,2006,2447554,769387,155642,693165,1618194,0.6611474149293539
4831,Romania,ROU,2007,2420229,762386,154329,689139,1605854,0.6635132460606
4832,Romania,ROU,2008,2393132,755377,152989,684522,1592888,0.6656080817940674
4833,Romania,ROU,2009,2368207,748553,151598,680981,1581132,0.6676494073364364
4834,Romania,ROU,2010,2344516,742282,150135,676721,1569138,0.6692801414023193
4835,Romania,ROU,2011,2325756,738408,148562,673094,1560064,0.6707771580509735
4836,Romania,ROU,2014,2284026,738937,144228,662942,1546107,0.6769218038673815
4837,Romania,ROU,2013,2298636,739268,145696,666311,1551275,0.6748676171433842
4838,Romania,ROU,2015,2264154,734411,142531,658487,1535429,0.678146892835028
4839,Romania,ROU,2016,2242864,726430,141007,655044,1522481,0.6788111093673089
4840,Romania,ROU,2017,2225513,719700,139717,652444,1511861,0.6793314620044907
4841,Romania,ROU,2005,2472934,775970,156899,696905,1629774,0.6590446813380382
4842,Romania,ROU,2019,2197435,713812,137311,647909,1499032,0.682173534143217
4843,Romania,ROU,2012,2310595,738013,147063,669499,1554575,0.6728028927613883
4844,Romania,ROU,2018,2210750,715961,138491,649991,1504443,0.6805124957593577
4845,Romania,ROU,2004,2495334,781097,157904,699382,1638383,0.656578638370655
4846,Romania,ROU,2002,2537506,788997,159549,703476,1652022,0.6510416133006188
4847,Romania,ROU,2003,2516089,785162,158749,701490,1645401,0.6539518276181805
4848,Romania,ROU,1990,2594889,808873,158027,690963,1657863,0.6388955365720845
4849,Romania,ROU,1991,2604619,813103,158729,692453,1664285,0.638974452693465
4850,Romania,ROU,1992,2609794,815730,159183,693477,1668390,0.6392803416668136
4851,Romania,ROU,1994,2613703,818002,159974,695609,1673585,0.640311848744865
4852,Romania,ROU,1995,2612562,818633,160350,697380,1676363,0.6416548200578589
4853,Romania,ROU,1993,2612069,816916,159544,694157,1670617,0.6395761367712721
4854,Romania,ROU,1997,2597992,810879,160690,700429,1671998,0.6435731903716408
4855,Romania,ROU,1998,2587472,804053,160589,701707,1666349,0.6440065824866897
4856,Romania,ROU,1999,2577052,797989,160470,702789,1661248,0.6446311521847444
4857,Romania,ROU,2000,2566983,794249,160320,704009,1658578,0.646119588637712
4858,Romania,ROU,2001,2554095,791827,160040,704167,1656034,0.6483838698247324
4859,Romania,ROU,1996,2607298,816374,160622,699037,1676033,0.6428237201884863
4860,Russia,RUS,2011,16587305,5050276,877237,5439237,11366750,0.6852680408300204
4861,Russia,RUS,2007,16998483,5124381,884618,5542776,11551775,0.6795768187078811
4862,Russia,RUS,2008,16855571,5102636,883149,5495174,11480959,0.6811373521549641
4863,Russia,RUS,2009,16727645,5081346,881384,5455120,11417850,0.6825736677219059
4864,Russia,RUS,2010,16634095,5063520,879506,5433725,11376751,0.6839416872393719
4865,Russia,RUS,2012,16578399,5042686,874384,5464357,11381427,0.686521478943775
4866,Russia,RUS,2006,17143062,5144633,885671,5586056,11616360,0.6776129025258149
4867,Russia,RUS,2014,16599763,5032608,868327,5515763,11416698,0.6877627108290643
4868,Russia,RUS,2015,16590236,5024629,864874,5519376,11408879,0.6876863596153786
4869,Russia,RUS,2016,16572121,5013524,861464,5511212,11386200,0.6870695670155921
4870,Russia,RUS,2017,16564505,5005220,858116,5503737,11367073,0.686230768743165
4871,Russia,RUS,2018,16560635,5002244,855598,5486843,11344685,0.6850392512122875
4872,Russia,RUS,2013,16590701,5038080,871533,5494216,11403829,0.6873626979354278
4873,Russia,RUS,2005,17282069,5165808,886141,5622030,11673979,0.6754966086525866
4874,Russia,RUS,2019,16542505,4999414,853008,5453827,11306249,0.683466560838277
4875,Russia,RUS,2003,17542527,5202067,884653,5689530,11776250,0.6712972424098307
4876,Russia,RUS,1990,16918750,5033420,839853,5401788,11275061,0.6664239970446989
4877,Russia,RUS,1991,17078438,5065576,844111,5467377,11377064,0.6661653717980532
4878,Russia,RUS,1992,17233809,5098760,848756,5528676,11476192,0.6659115230997396
4879,Russia,RUS,1993,17359634,5125527,852295,5575100,11552922,0.6655049294242033
4880,Russia,RUS,1994,17444306,5141373,854140,5605365,11600878,0.665023761908327
4881,Russia,RUS,1995,17516551,5154949,856496,5632485,11643930,0.6647387376658795
4882,Russia,RUS,2004,17411984,5184624,885780,5654347,11724751,0.6733724887410878
4883,Russia,RUS,1997,17687785,5191944,864145,5689457,11745546,0.664048437947431
4884,Russia,RUS,1998,17761437,5209450,869242,5714849,11793541,0.6639970065485129
4885,Russia,RUS,1999,17798615,5219835,873460,5731196,11824491,0.664348939510181
4886,Russia,RUS,2000,17795668,5223971,877087,5740841,11841899,0.6654371726871956
4887,Russia,RUS,2001,17748196,5222599,880164,5737958,11840721,0.6671506782999241
4888,Russia,RUS,2002,17662308,5216096,882706,5720560,11819362,0.6691855900146232
4889,Russia,RUS,1996,17599826,5171994,859718,5660773,11692485,0.66435230666485
4890,Rwanda,RWA,2007,1089988,297672,46819,366145,710636,0.6519668106437869
4891,Rwanda,RWA,2009,1127317,313293,49397,373979,736669,0.6534710290007159
4892,Rwanda,RWA,2010,1155437,323043,51014,383747,757804,0.655859211709509
4893,Rwanda,RWA,2011,1186802,333864,52695,396513,783072,0.6598168860517593
4894,Rwanda,RWA,2012,1219577,345642,54376,409166,809184,0.6634956218426553
4895,Rwanda,RWA,2013,1249627,356709,55850,421024,833583,0.6670654523309756
4896,Rwanda,RWA,2016,1346371,393650,60841,461187,915678,0.6801082316835404
4897,Rwanda,RWA,2015,1307551,379010,58901,445325,883236,0.6754887572262955
4898,Rwanda,RWA,2006,1071260,289898,45525,362447,697870,0.6514478277915725
4899,Rwanda,RWA,2017,1384172,407360,62725,477022,947107,0.6842408313417697
4900,Rwanda,RWA,2018,1420164,418467,64614,493401,976482,0.687583969175391
4901,Rwanda,RWA,2019,1457729,428380,66584,512062,1007026,0.6908183894262926
4902,Rwanda,RWA,2014,1275306,367024,57212,431853,856089,0.6712812454422703
4903,Rwanda,RWA,2005,1047486,281359,44090,355551,681000,0.6501280208040967
4904,Rwanda,RWA,2008,1106518,304879,47995,368747,721621,0.6521547774188943
4905,Rwanda,RWA,2003,1004733,265796,41436,341340,648572,0.6455167691316996
4906,Rwanda,RWA,2004,1024885,273281,42735,348199,664215,0.6480873463852042
4907,Rwanda,RWA,1991,827962,214496,33270,288184,535950,0.6473123162657224
4908,Rwanda,RWA,1992,763759,196911,30460,266089,493460,0.6460938594504287
4909,Rwanda,RWA,1993,630928,161977,24992,220397,407366,0.6456616285851952
4910,Rwanda,RWA,1994,610219,156433,23896,212104,392433,0.6431019027595011
4911,Rwanda,RWA,1995,686147,176048,26693,236470,439211,0.6401121042575425
4912,Rwanda,RWA,1996,799631,205273,31189,273733,510195,0.6380380450482785
4913,Rwanda,RWA,1990,797133,207737,32306,277567,517610,0.6493395706864475
4914,Rwanda,RWA,1998,896590,231083,35380,305023,571486,0.6373994802529585
4915,Rwanda,RWA,1999,914661,236464,36337,310493,583294,0.6377160499901057
4916,Rwanda,RWA,2000,937377,243266,37503,317815,598584,0.6385733808275645
4917,Rwanda,RWA,2001,961214,250725,38781,325937,615443,0.6402767749949543
4918,Rwanda,RWA,2002,983456,258281,40101,333728,632110,0.6427435492792763
4919,Rwanda,RWA,1997,874610,224887,34286,298094,557267,0.6371605629937915
4920,Saint Kitts and Nevis,KNA,2007,7640,2278,503,2089,4870,0.637434554973822
4921,Saint Kitts and Nevis,KNA,2019,9036,2797,608,2664,6069,0.6716467463479415
4922,Saint Kitts and Nevis,KNA,2009,7902,2375,524,2180,5079,0.6427486712224754
4923,Saint Kitts and Nevis,KNA,2010,8030,2422,535,2227,5184,0.6455790784557908
4924,Saint Kitts and Nevis,KNA,2011,8159,2469,544,2277,5290,0.6483637700698615
4925,Saint Kitts and Nevis,KNA,2012,8288,2519,554,2327,5400,0.6515444015444015
4926,Saint Kitts and Nevis,KNA,2015,8650,2660,580,2476,5716,0.6608092485549133
4927,Saint Kitts and Nevis,KNA,2014,8537,2617,572,2428,5617,0.6579594705400024
4928,Saint Kitts and Nevis,KNA,2016,8750,2690,588,2525,5803,0.6632
4929,Saint Kitts and Nevis,KNA,2017,8843,2718,595,2573,5886,0.6656112179124731
4930,Saint Kitts and Nevis,KNA,2018,8941,2755,602,2619,5976,0.6683816127949894
4931,Saint Kitts and Nevis,KNA,2006,7508,2230,492,2044,4766,0.634789557805008
4932,Saint Kitts and Nevis,KNA,2013,8417,2569,563,2378,5510,0.654627539503386
4933,Saint Kitts and Nevis,KNA,2005,7373,2184,481,1997,4662,0.6323070663230707
4934,Saint Kitts and Nevis,KNA,2008,7771,2327,514,2133,4974,0.6400720627975808
4935,Saint Kitts and Nevis,KNA,2003,7096,2093,459,1901,4453,0.6275366403607666
4936,Saint Kitts and Nevis,KNA,1990,5779,1671,349,1466,3486,0.6032185499221319
4937,Saint Kitts and Nevis,KNA,1991,5790,1677,352,1473,3502,0.6048359240069084
4938,Saint Kitts and Nevis,KNA,1992,5830,1690,356,1487,3533,0.6060034305317324
4939,Saint Kitts and Nevis,KNA,1993,5887,1709,361,1506,3576,0.6074401223033803
4940,Saint Kitts and Nevis,KNA,1994,5962,1733,368,1529,3630,0.6088560885608856
4941,Saint Kitts and Nevis,KNA,1995,6052,1762,375,1556,3693,0.6102115003304692
4942,Saint Kitts and Nevis,KNA,2004,7236,2138,470,1949,4557,0.6297678275290216
4943,Saint Kitts and Nevis,KNA,1997,6274,1831,393,1627,3851,0.6138029964934651
4944,Saint Kitts and Nevis,KNA,1998,6403,1871,403,1670,3944,0.6159612681555521
4945,Saint Kitts and Nevis,KNA,1999,6539,1913,413,1715,4041,0.6179844012846001
4946,Saint Kitts and Nevis,KNA,2000,6677,1958,424,1760,4142,0.6203384753631871
4947,Saint Kitts and Nevis,KNA,2001,6818,2003,436,1806,4245,0.6226166031094162
4948,Saint Kitts and Nevis,KNA,2002,6958,2048,447,1854,4349,0.6250359298649037
4949,Saint Kitts and Nevis,KNA,1996,6157,1795,383,1589,3767,0.6118239402306318
4950,Saint Lucia,LCA,2007,23394,7215,1596,5417,14228,0.6081901342224502
4951,Saint Lucia,LCA,2009,23875,7450,1647,5592,14689,0.6152460732984293
4952,Saint Lucia,LCA,2010,24102,7557,1671,5687,14915,0.6188283130030703
4953,Saint Lucia,LCA,2011,24331,7661,1694,5797,15152,0.6227446467469483
4954,Saint Lucia,LCA,2012,24558,7768,1716,5913,15397,0.6269647365420636
4955,Saint Lucia,LCA,2015,25142,8053,1772,6243,16068,0.6390899689762151
4956,Saint Lucia,LCA,2014,24971,7969,1755,6143,15867,0.635417083817228
4957,Saint Lucia,LCA,2006,23138,7097,1570,5327,13994,0.6048059469271329
4958,Saint Lucia,LCA,2016,25273,8122,1788,6325,16235,0.6423851541170419
4959,Saint Lucia,LCA,2017,25379,8181,1802,6403,16386,0.6456519169392017
4960,Saint Lucia,LCA,2018,25512,8234,1815,6519,16568,0.6494198808403888
4961,Saint Lucia,LCA,2019,25665,8280,1826,6677,16783,0.6539255795830898
4962,Saint Lucia,LCA,2013,24775,7872,1736,6031,15639,0.6312411705348133
4963,Saint Lucia,LCA,2005,22870,6985,1543,5232,13760,0.6016615653694797
4964,Saint Lucia,LCA,2008,23632,7335,1622,5501,14458,0.6117975626269465
4965,Saint Lucia,LCA,2003,22291,6774,1489,5019,13282,0.595845857072361
4966,Saint Lucia,LCA,1990,18160,5331,1137,3780,10248,0.5643171806167401
4967,Saint Lucia,LCA,1991,18431,5427,1163,3844,10434,0.5661114426780967
4968,Saint Lucia,LCA,1992,18711,5527,1188,3912,10627,0.5679546790657902
4969,Saint Lucia,LCA,1993,19004,5629,1215,3983,10827,0.569722163754999
4970,Saint Lucia,LCA,1994,19306,5736,1241,4064,11041,0.5718947477468145
4971,Saint Lucia,LCA,1995,19628,5847,1268,4155,11270,0.5741797432239658
4972,Saint Lucia,LCA,2004,22584,6879,1516,5127,13522,0.5987424725469359
4973,Saint Lucia,LCA,1997,20301,6082,1323,4356,11761,0.5793310674351018
4974,Saint Lucia,LCA,1998,20650,6205,1351,4465,12021,0.5821307506053269
4975,Saint Lucia,LCA,1999,20996,6327,1379,4578,12284,0.58506382168032
4976,Saint Lucia,LCA,2000,21336,6446,1407,4688,12541,0.5877859017622797
4977,Saint Lucia,LCA,2001,21667,6560,1435,4798,12793,0.59043707019892
4978,Saint Lucia,LCA,2002,21985,6669,1462,4910,13041,0.5931771662497157
4979,Saint Lucia,LCA,1996,19962,5962,1295,4252,11509,0.5765454363290251
4980,Saint Vincent and the Grenadines,VCT,2006,15405,4669,1018,3572,9259,0.601038623823434
4981,Saint Vincent and the Grenadines,VCT,2007,15471,4712,1026,3606,9344,0.6039687156615603
4982,Saint Vincent and the Grenadines,VCT,2008,15540,4758,1034,3639,9431,0.6068854568854569
4983,Saint Vincent and the Grenadines,VCT,2009,15610,4804,1042,3672,9518,0.6097373478539397
4984,Saint Vincent and the Grenadines,VCT,2010,15680,4846,1051,3712,9609,0.6128188775510204
4985,Saint Vincent and the Grenadines,VCT,2011,15764,4888,1059,3761,9708,0.6158335447855874
4986,Saint Vincent and the Grenadines,VCT,2015,16076,5052,1087,3977,10116,0.6292610102015427
4987,Saint Vincent and the Grenadines,VCT,2013,15938,4978,1074,3877,9929,0.6229765340695194
4988,Saint Vincent and the Grenadines,VCT,2014,16017,5018,1081,3930,10029,0.6261472185802585
4989,Saint Vincent and the Grenadines,VCT,2016,16111,5074,1093,4009,10176,0.6316181490906834
4990,Saint Vincent and the Grenadines,VCT,2017,16145,5095,1098,4041,10234,0.6338804583462372
4991,Saint Vincent and the Grenadines,VCT,2018,16204,5127,1103,4102,10332,0.637620340656628
4992,Saint Vincent and the Grenadines,VCT,2005,15338,4632,1010,3533,9175,0.5981875081496936
4993,Saint Vincent and the Grenadines,VCT,2012,15850,4933,1066,3816,9815,0.6192429022082019
4994,Saint Vincent and the Grenadines,VCT,2019,16303,5169,1108,4191,10468,0.6420904128074587
4995,Saint Vincent and the Grenadines,VCT,2004,15280,4601,1002,3491,9094,0.5951570680628272
4996,Saint Vincent and the Grenadines,VCT,2002,15164,4548,988,3396,8932,0.5890266420469533
4997,Saint Vincent and the Grenadines,VCT,1990,14803,4293,899,3015,8207,0.5544146456799297
4998,Saint Vincent and the Grenadines,VCT,1991,14846,4324,910,3027,8261,0.5564461807894382
4999,Saint Vincent and the Grenadines,VCT,1992,14882,4350,919,3043,8312,0.5585270796935896
5000,Saint Vincent and the Grenadines,VCT,1993,14910,4373,928,3060,8361,0.5607645875251509
5001,Saint Vincent and the Grenadines,VCT,1994,14934,4394,936,3082,8412,0.5632784250703093
5002,Saint Vincent and the Grenadines,VCT,1995,14955,4413,944,3109,8466,0.5660982948846539
5003,Saint Vincent and the Grenadines,VCT,2003,15217,4573,995,3443,9011,0.5921666557140041
5004,Saint Vincent and the Grenadines,VCT,1997,15001,4450,957,3183,8590,0.5726284914339044
5005,Saint Vincent and the Grenadines,VCT,1998,15027,4468,964,3227,8659,0.5762294536500965
5006,Saint Vincent and the Grenadines,VCT,1999,15058,4486,970,3270,8726,0.5794926285031212
5007,Saint Vincent and the Grenadines,VCT,2000,15082,4504,976,3309,8789,0.5827476462007691
5008,Saint Vincent and the Grenadines,VCT,2001,15120,4525,982,3351,8858,0.5858465608465608
5009,Saint Vincent and the Grenadines,VCT,1996,14977,4432,951,3143,8526,0.569272885090472
5010,Samoa,WSM,2007,19476,6847,443,4434,11724,0.6019716574245225
5011,Samoa,WSM,2008,19596,6921,447,4450,11818,0.6030822616860584
5012,Samoa,WSM,2010,19917,7077,455,4505,12037,0.6043580860571371
5013,Samoa,WSM,2011,20151,7173,460,4556,12189,0.6048831323507519
5014,Samoa,WSM,2012,20441,7292,466,4620,12378,0.6055476737928672
5015,Samoa,WSM,2015,21503,7714,490,4855,13059,0.6073106078221644
5016,Samoa,WSM,2014,21131,7570,482,4769,12821,0.6067389143911789
5017,Samoa,WSM,2006,19368,6779,439,4414,11632,0.600578273440727
5018,Samoa,WSM,2016,21849,7840,500,4937,13277,0.6076708316170076
5019,Samoa,WSM,2017,22192,7968,509,5027,13504,0.608507570295602
5020,Samoa,WSM,2018,22598,8128,519,5135,13782,0.6098769802637402
5021,Samoa,WSM,2019,23034,8314,529,5263,14106,0.6123990622557958
5022,Samoa,WSM,2013,20772,7427,474,4690,12591,0.6061525129982669
5023,Samoa,WSM,2004,19154,6669,431,4359,11459,0.5982562389057116
5024,Samoa,WSM,2009,19740,6997,451,4473,11921,0.6039007092198582
5025,Samoa,WSM,2005,19261,6720,435,4390,11545,0.5993977467421214
5026,Samoa,WSM,2003,19053,6622,427,4327,11376,0.5970713273500237
5027,Samoa,WSM,1990,17524,5967,372,3884,10223,0.5833713763980827
5028,Samoa,WSM,1991,17622,6006,375,3913,10294,0.5841561684258314
5029,Samoa,WSM,1992,17735,6050,379,3946,10375,0.5850014096419509
5030,Samoa,WSM,1994,17965,6143,387,4022,10552,0.5873643195101587
5031,Samoa,WSM,1995,18090,6191,392,4060,10643,0.5883360972913212
5032,Samoa,WSM,1993,17849,6095,383,3983,10461,0.5860832539638074
5033,Samoa,WSM,1997,18340,6298,401,4130,10829,0.5904580152671756
5034,Samoa,WSM,1998,18462,6357,405,4160,10922,0.5915935434947459
5035,Samoa,WSM,1999,18590,6417,409,4192,11018,0.592684238838085
5036,Samoa,WSM,2000,18718,6474,414,4226,11114,0.5937600170958436
5037,Samoa,WSM,2001,18839,6527,418,4261,11206,0.5948298741971442
5038,Samoa,WSM,2002,18951,6576,423,4295,11294,0.5959579969394755
5039,Samoa,WSM,1996,18214,6242,396,4096,10734,0.5893268914022181
5040,San Marino,SMR,2010,4721,1781,317,1455,3553,0.7525947892395679
5041,San Marino,SMR,2006,4510,1703,302,1383,3388,0.751219512195122
5042,San Marino,SMR,2007,4564,1723,306,1401,3430,0.7515337423312883
5043,San Marino,SMR,2008,4617,1742,310,1419,3471,0.7517868745938922
5044,San Marino,SMR,2009,4670,1762,313,1437,3512,0.75203426124197
5045,San Marino,SMR,2011,4772,1802,321,1472,3595,0.7533528918692373
5046,San Marino,SMR,2005,4454,1683,299,1364,3346,0.7512348450830714
5047,San Marino,SMR,2013,4870,1845,327,1506,3678,0.7552361396303902
5048,San Marino,SMR,2014,4916,1865,331,1521,3717,0.7561025223759154
5049,San Marino,SMR,2015,4958,1882,334,1536,3752,0.7567567567567568
5050,San Marino,SMR,2016,4996,1896,337,1551,3784,0.7574059247397918
5051,San Marino,SMR,2017,5030,1909,340,1564,3813,0.758051689860835
5052,San Marino,SMR,2018,5064,1921,342,1578,3841,0.7584913112164297
5053,San Marino,SMR,2012,4823,1824,324,1489,3637,0.7540949616421314
5054,San Marino,SMR,2019,5096,1934,345,1592,3871,0.7596153846153846
5055,San Marino,SMR,2004,4396,1661,295,1346,3302,0.7511373976342129
5056,San Marino,SMR,2002,4278,1616,287,1308,3211,0.7505843852267414
5057,San Marino,SMR,1990,3582,1354,239,1068,2661,0.7428810720268006
5058,San Marino,SMR,1991,3637,1375,244,1088,2707,0.7442947484190267
5059,San Marino,SMR,1992,3692,1396,248,1107,2751,0.745124593716143
5060,San Marino,SMR,1993,3749,1418,252,1127,2797,0.7460656174979995
5061,San Marino,SMR,1994,3805,1439,256,1147,2842,0.7469119579500657
5062,San Marino,SMR,1995,3862,1460,260,1167,2887,0.7475401346452615
5063,San Marino,SMR,2003,4337,1639,291,1327,3257,0.7509799400507263
5064,San Marino,SMR,1997,3980,1504,268,1208,2980,0.7487437185929648
5065,San Marino,SMR,1998,4038,1526,272,1228,3026,0.7493808816245666
5066,San Marino,SMR,1999,4098,1549,276,1249,3074,0.7501220107369448
5067,San Marino,SMR,2000,4159,1571,279,1269,3119,0.7499398893964896
5068,San Marino,SMR,2001,4218,1593,283,1288,3164,0.7501185395922239
5069,San Marino,SMR,1996,3920,1482,264,1188,2934,0.7484693877551021
5070,Sao Tome and Principe,STP,2006,15158,4485,737,4402,9624,0.634912257553767
5071,Sao Tome and Principe,STP,2007,15493,4589,757,4505,9851,0.6358355386303491
5072,Sao Tome and Principe,STP,2008,15834,4698,777,4609,10084,0.6368573954780852
5073,Sao Tome and Principe,STP,2009,16195,4813,799,4724,10336,0.638221673355974
5074,Sao Tome and Principe,STP,2010,16590,4935,821,4848,10604,0.6391802290536468
5075,Sao Tome and Principe,STP,2011,17003,5064,844,4989,10897,0.6408869023113568
5076,Sao Tome and Principe,STP,2014,18340,5494,918,5468,11880,0.6477644492911668
5077,Sao Tome and Principe,STP,2013,17884,5346,893,5302,11541,0.6453254305524491
5078,Sao Tome and Principe,STP,2015,18800,5641,945,5633,12219,0.6499468085106384
5079,Sao Tome and Principe,STP,2016,19257,5794,972,5798,12564,0.6524380744664278
5080,Sao Tome and Principe,STP,2017,19722,5947,1000,5973,12920,0.6551059730250481
5081,Sao Tome and Principe,STP,2005,14834,4386,718,4295,9399,0.6336119724956182
5082,Sao Tome and Principe,STP,2019,20731,6237,1059,6427,13723,0.6619555255414596
5083,Sao Tome and Principe,STP,2012,17433,5202,868,5142,11212,0.6431480525440257
5084,Sao Tome and Principe,STP,2018,20217,6093,1029,6181,13303,0.6580105851511104
5085,Sao Tome and Principe,STP,2004,14523,4294,699,4188,9181,0.6321696619155822
5086,Sao Tome and Principe,STP,2002,13947,4127,664,3985,8776,0.6292392629239263
5087,Sao Tome and Principe,STP,2003,14224,4208,681,4085,8974,0.6309055118110236
5088,Sao Tome and Principe,STP,1990,11205,3309,520,3181,7010,0.6256135653726015
5089,Sao Tome and Principe,STP,1991,11442,3381,530,3230,7141,0.6241041775913302
5090,Sao Tome and Principe,STP,1992,11671,3451,541,3279,7271,0.6229971724787936
5091,Sao Tome and Principe,STP,1994,12110,3583,562,3385,7530,0.6218001651527663
5092,Sao Tome and Principe,STP,1995,12328,3648,572,3444,7664,0.6216742375081116
5093,Sao Tome and Principe,STP,1993,11890,3518,551,3329,7398,0.6222035323801514
5094,Sao Tome and Principe,STP,1997,12756,3776,595,3576,7947,0.6230009407337723
5095,Sao Tome and Principe,STP,1998,12974,3841,607,3648,8096,0.6240172652998305
5096,Sao Tome and Principe,STP,1999,13198,3907,620,3725,8252,0.6252462494317321
5097,Sao Tome and Principe,STP,2000,13437,3976,634,3807,8417,0.6264047034308253
5098,Sao Tome and Principe,STP,2001,13685,4050,649,3893,8592,0.6278407014979905
5099,Sao Tome and Principe,STP,1996,12537,3712,584,3506,7802,0.6223179389008535
5100,Saudi Arabia,SAU,2011,3938560,1389013,240624,1230966,2860603,0.72630682279818
5101,Saudi Arabia,SAU,2007,3328663,1174289,199191,1003258,2376738,0.7140218159663505
5102,Saudi Arabia,SAU,2008,3476249,1226407,209077,1058408,2493892,0.7174089082801606
5103,Saudi Arabia,SAU,2009,3628759,1280392,219434,1115076,2614902,0.7206050332909957
5104,Saudi Arabia,SAU,2010,3784477,1334559,230047,1173240,2737846,0.7234410461471955
5105,Saudi Arabia,SAU,2019,5087952,1775805,317603,1686321,3779729,0.7428782740088743
5106,Saudi Arabia,SAU,2006,3190497,1125469,189939,952805,2268213,0.7109277958888537
5107,Saudi Arabia,SAU,2014,4398918,1552827,271494,1407758,3232079,0.73474408934197
5108,Saudi Arabia,SAU,2015,4544286,1602011,281324,1464782,3348117,0.736775150155602
5109,Saudi Arabia,SAU,2016,4679058,1644241,290885,1515762,3450888,0.7375176798406858
5110,Saudi Arabia,SAU,2017,4807117,1684116,300133,1565697,3549946,0.7384771371281373
5111,Saudi Arabia,SAU,2018,4944747,1728285,309042,1622742,3660069,0.7401933809758113
5112,Saudi Arabia,SAU,2013,4247666,1499710,261399,1349311,3110420,0.7322656724893153
5113,Saudi Arabia,SAU,2005,3063803,1081142,181438,907945,2170525,0.7084414369983971
5114,Saudi Arabia,SAU,2012,4094122,1444551,251092,1290636,2986279,0.7294064514931407
5115,Saudi Arabia,SAU,2003,2852248,1006531,167119,833932,2007582,0.703859552184803
5116,Saudi Arabia,SAU,1990,1902939,665902,106299,523884,1296085,0.6810964513313353
5117,Saudi Arabia,SAU,1991,1984635,694813,111277,547341,1353431,0.6819546163400323
5118,Saudi Arabia,SAU,1992,2063171,722874,116138,570434,1409446,0.683145507570628
5119,Saudi Arabia,SAU,1993,2137871,749510,120778,592948,1463236,0.6844360581157609
5120,Saudi Arabia,SAU,1994,2208821,774892,125234,615146,1515272,0.6860094140720321
5121,Saudi Arabia,SAU,1995,2276979,799254,129561,636676,1565491,0.6875298366827274
5122,Saudi Arabia,SAU,2004,2951657,1041515,173793,868763,2084071,0.7060681508725438
5123,Saudi Arabia,SAU,1997,2409726,847237,137928,680541,1665706,0.691242904794985
5124,Saudi Arabia,SAU,1998,2476127,871464,142115,702958,1716537,0.6932346361878854
5125,Saudi Arabia,SAU,1999,2543683,895990,146431,726093,1768514,0.6952572313452581
5126,Saudi Arabia,SAU,2000,2613532,920950,150993,750085,1822028,0.6971515940880004
5127,Saudi Arabia,SAU,2001,2686523,947029,155881,775653,1878563,0.699254389409657
5128,Saudi Arabia,SAU,2002,2765879,975304,161210,803149,1939663,0.7012826663783919
5129,Saudi Arabia,SAU,1996,2343456,823188,133768,658370,1615326,0.689292224816681
5130,Scotland,,2007,706762,230775,54594,229569,514938,0.7285875584708855
5131,Scotland,,2009,717588,233750,55326,235805,524881,0.7314517522589564
5132,Scotland,,2010,722363,234990,55664,238609,529263,0.7326828755071896
5133,Scotland,,2011,727166,236253,55987,241285,533525,0.7337045461421463
5134,Scotland,,2012,732489,237705,56301,244078,538084,0.7345966970152453
5135,Scotland,,2013,737592,239186,56591,246523,542300,0.7352303170316381
5136,Scotland,,2016,746984,240820,57198,251472,549490,0.7356114722671436
5137,Scotland,,2015,745451,241383,57035,250233,548651,0.735998744384272
5138,Scotland,,2006,702050,229312,54206,227007,510525,0.7271917954561641
5139,Scotland,,2017,748126,240145,57339,252415,549899,0.7350352748066502
5140,Scotland,,2018,749943,240771,57457,252805,551033,0.7347665089213447
5141,Scotland,,2019,751989,241955,57547,252693,552195,0.7343126029769053
5142,Scotland,,2014,742099,240486,56838,248657,545981,0.735725287326893
5143,Scotland,,2005,698500,228050,53832,225560,507442,0.7264738725841088
5144,Scotland,,2008,712164,232305,54971,232640,519916,0.7300509433220438
5145,Scotland,,2003,698400,226249,53283,229189,508721,0.7284092210767469
5146,Scotland,,2004,697351,227059,53516,226313,506888,0.7268764223468526
5147,Scotland,,1991,703594,220134,51997,244603,516734,0.7344207028485178
5148,Scotland,,1992,699946,220470,51986,240986,513442,0.7335451591979952
5149,Scotland,,1993,696948,220749,51989,237977,510715,0.7327878120031911
5150,Scotland,,1994,695171,221062,52044,236004,509110,0.7323521838511675
5151,Scotland,,1995,695060,221437,52142,235268,508847,0.7320907547549852
5152,Scotland,,1996,696104,221880,52238,235440,509558,0.7320141817889281
5153,Scotland,,1990,707390,219713,51985,248447,520145,0.7353016016624493
5154,Scotland,,1998,698851,222976,52421,236320,511717,0.7322261826913034
5155,Scotland,,1999,700092,223504,52546,236851,512901,0.7326194271610017
5156,Scotland,,2000,701310,224079,52717,237129,513925,0.7328071751436597
5157,Scotland,,2001,701558,224756,52907,236022,513685,0.7322060328582954
5158,Scotland,,2002,700164,225495,53090,232894,511479,0.7305131369222068
5159,Scotland,,1997,697476,222417,52324,235819,510560,0.7320108505525638
5160,Senegal,SEN,2007,1095247,307630,52793,334273,694696,0.6342824951814522
5161,Senegal,SEN,2009,1144936,320963,55412,350044,726419,0.6344625376440255
5162,Senegal,SEN,2010,1171731,328324,56747,358504,743575,0.6345953124053217
5163,Senegal,SEN,2011,1201011,336443,58117,368451,763011,0.6353072536388094
5164,Senegal,SEN,2012,1232108,345229,59543,379797,784569,0.636769666295487
5165,Senegal,SEN,2013,1264611,354498,61029,391711,807238,0.6383290988296005
5166,Senegal,SEN,2016,1364229,383164,65806,425907,874877,0.6412977586607527
5167,Senegal,SEN,2015,1331791,373540,64150,415155,852845,0.6403745032065842
5168,Senegal,SEN,2017,1395953,392911,67539,436681,897131,0.6426656198310402
5169,Senegal,SEN,2018,1430627,402844,69347,449910,922101,0.6445432666935547
5170,Senegal,SEN,2019,1468264,413083,71209,465405,949697,0.6468162401312025
5171,Senegal,SEN,2006,1070987,301169,51511,326582,679262,0.6342392578061171
5172,Senegal,SEN,2014,1298783,364018,62561,403791,830370,0.639344678826255
5173,Senegal,SEN,2005,1046667,294512,50246,318490,663248,0.6336762313133021
5174,Senegal,SEN,2008,1119337,314155,54099,341875,710129,0.6344193035698811
5175,Senegal,SEN,2003,997743,280619,47696,302008,630323,0.6317488571706341
5176,Senegal,SEN,1991,708076,197825,32520,210617,440962,0.6227608335828357
5177,Senegal,SEN,1992,730786,204080,33607,217222,454909,0.6224927680606909
5178,Senegal,SEN,1993,754074,210556,34747,224013,469316,0.6223739314709167
5179,Senegal,SEN,1994,777878,217215,35939,231396,484550,0.6229125904062076
5180,Senegal,SEN,1995,802049,224039,37177,239028,500244,0.6237075290911154
5181,Senegal,SEN,1996,826450,230993,38448,246689,516130,0.6245144896847964
5182,Senegal,SEN,1990,686287,191826,31493,204360,427679,0.6231780581593415
5183,Senegal,SEN,1998,874372,245131,41075,261154,547360,0.6260035774247117
5184,Senegal,SEN,1997,850418,238038,39752,253961,531751,0.6252819201851325
5185,Senegal,SEN,2002,972968,273551,46392,293625,613568,0.6306147786977578
5186,Senegal,SEN,2001,948373,266430,45070,285226,596726,0.6292102369004601
5187,Senegal,SEN,2004,1022200,287614,48977,310187,646778,0.6327313637252984
5188,Senegal,SEN,2000,923359,259316,43740,276675,579731,0.6278500561536737
5189,Senegal,SEN,1999,898494,252226,42405,268508,563139,0.6267587763524297
5190,Serbia,SRB,2006,1080469,343394,56002,323455,722851,0.6690159551083835
5191,Serbia,SRB,2007,1072782,342103,55724,320905,718732,0.6699702269426594
5192,Serbia,SRB,2008,1063297,340292,55351,317980,713623,0.6711417412068312
5193,Serbia,SRB,2009,1054921,338642,55037,315467,709146,0.6722266406678794
5194,Serbia,SRB,2010,1049030,337367,54813,313926,706106,0.6731037243930107
5195,Serbia,SRB,2011,1046469,336830,54729,313417,704976,0.6736711742058293
5196,Serbia,SRB,2012,1045201,336595,54692,313014,704301,0.6738426388799857
5197,Serbia,SRB,2013,1040833,335245,54424,311931,701600,0.6740754760850204
5198,Serbia,SRB,2014,1035732,333651,54125,310662,698438,0.6743423974541677
5199,Serbia,SRB,2016,1030386,331449,53779,310645,695873,0.6753517613787454
5200,Serbia,SRB,2017,1027383,329979,53556,311124,694659,0.6761441448807309
5201,Serbia,SRB,2018,1022803,328681,53303,310335,692319,0.6768840138325758
5202,Serbia,SRB,2005,1087164,344315,56196,325389,725900,0.6677005493191459
5203,Serbia,SRB,2019,1017420,327318,53050,309003,689371,0.6775677694560752
5204,Serbia,SRB,2015,1032898,332736,53959,310176,696871,0.6746755245919732
5205,Serbia,SRB,2004,1095992,345933,56523,327921,730377,0.6664072365491719
5206,Serbia,SRB,2002,1108558,346964,56888,331809,735661,0.6636197654971594
5207,Serbia,SRB,2003,1104673,347213,56831,330423,734467,0.6648727723045643
5208,Serbia,SRB,1990,1078874,330543,55221,324029,709793,0.65790166414243
5209,Serbia,SRB,1991,1105636,338801,56639,330769,726209,0.6568246692401477
5210,Serbia,SRB,1992,1122352,344020,57491,335064,736575,0.6562780660612714
5211,Serbia,SRB,1994,1140864,350365,58451,340005,748821,0.6563630721979131
5212,Serbia,SRB,1995,1144163,351729,58623,341162,751514,0.6568242461956907
5213,Serbia,SRB,1993,1130291,346839,57894,337121,741854,0.656338942803225
5214,Serbia,SRB,1997,1122038,346331,57374,335652,739357,0.6589411410308742
5215,Serbia,SRB,1998,1093583,338752,55818,328678,723248,0.6613562939438524
5216,Serbia,SRB,1999,1109629,344386,56717,332567,733670,0.6611849546109555
5217,Serbia,SRB,2000,1127939,350699,57789,336901,745389,0.6608415880646028
5218,Serbia,SRB,2001,1117367,348331,57253,334178,739762,0.6620582136397442
5219,Serbia,SRB,1996,1144783,352414,58640,341511,752565,0.6573865964117217
5220,Seychelles,SYC,2011,10129,3661,343,2654,6658,0.6573205647151743
5221,Seychelles,SYC,2007,9589,3428,320,2481,6229,0.6495984982792783
5222,Seychelles,SYC,2008,9722,3489,326,2520,6335,0.6516148940547213
5223,Seychelles,SYC,2009,9856,3549,332,2560,6441,0.653510551948052
5224,Seychelles,SYC,2010,9992,3606,337,2605,6548,0.655324259407526
5225,Seychelles,SYC,2012,10265,3717,348,2704,6769,0.6594252313687287
5226,Seychelles,SYC,2019,11153,4079,380,3048,7507,0.6730924414955617
5227,Seychelles,SYC,2014,10535,3827,358,2805,6990,0.6635026103464642
5228,Seychelles,SYC,2015,10660,3878,363,2851,7092,0.6652908067542214
5229,Seychelles,SYC,2016,10778,3930,367,2894,7191,0.667192429022082
5230,Seychelles,SYC,2017,10895,3980,372,2937,7289,0.6690224873795318
5231,Seychelles,SYC,2018,11018,4028,376,2988,7392,0.6709021601016518
5232,Seychelles,SYC,2006,9454,3369,315,2442,6126,0.647979691136027
5233,Seychelles,SYC,2013,10401,3773,353,2755,6881,0.6615710027881935
5234,Seychelles,SYC,2005,9316,3313,309,2399,6021,0.6463074280807214
5235,Seychelles,SYC,2001,8726,3103,284,2219,5606,0.6424478569791428
5236,Seychelles,SYC,2003,9029,3210,296,2311,5817,0.6442573928452763
5237,Seychelles,SYC,1991,7572,2612,233,1871,4716,0.6228209191759112
5238,Seychelles,SYC,1992,7667,2656,237,1898,4791,0.6248858745271945
5239,Seychelles,SYC,1993,7763,2701,241,1927,4869,0.6272059770707201
5240,Seychelles,SYC,1994,7861,2746,246,1958,4950,0.629690879023025
5241,Seychelles,SYC,1995,7961,2791,250,1988,5029,0.6317045597286773
5242,Seychelles,SYC,1996,8066,2837,255,2021,5113,0.6338953632531614
5243,Seychelles,SYC,1990,7483,2570,229,1845,4644,0.6206067085393558
5244,Seychelles,SYC,1998,8296,2936,265,2089,5290,0.6376567020250723
5245,Seychelles,SYC,1999,8430,2990,271,2129,5390,0.6393831553973903
5246,Seychelles,SYC,2000,8574,3047,277,2173,5497,0.6411243293678563
5247,Seychelles,SYC,2004,9173,3261,303,2353,5917,0.6450452414695301
5248,Seychelles,SYC,2002,8880,3158,290,2265,5713,0.6433558558558559
5249,Seychelles,SYC,1997,8175,2885,260,2053,5198,0.6358409785932722
5250,Sierra Leone,SLE,2007,620352,187910,24872,183028,395810,0.6380409831837408
5251,Sierra Leone,SLE,2008,640788,194566,25761,189255,409582,0.6391848786182014
5252,Sierra Leone,SLE,2009,662334,201687,26707,195805,424199,0.6404608550972772
5253,Sierra Leone,SLE,2010,684278,208968,27666,202613,439247,0.6419130821099027
5254,Sierra Leone,SLE,2012,727597,224456,29675,216628,470759,0.6470051415824969
5255,Sierra Leone,SLE,2013,750246,232750,30758,224242,487750,0.6501200939425202
5256,Sierra Leone,SLE,2016,823765,258824,34214,248193,541231,0.6570211164591844
5257,Sierra Leone,SLE,2015,797463,249715,33020,239893,522628,0.6553633209315041
5258,Sierra Leone,SLE,2017,850680,268023,35441,256922,560386,0.6587506465415902
5259,Sierra Leone,SLE,2018,878202,276621,36705,266195,579521,0.6598948761218945
5260,Sierra Leone,SLE,2019,905735,284839,38006,275540,598385,0.6606623350096883
5261,Sierra Leone,SLE,2006,602174,182087,24101,177581,383769,0.6373058285478947
5262,Sierra Leone,SLE,2014,773276,241203,31877,231955,505035,0.6531109202923665
5263,Sierra Leone,SLE,2005,584864,176721,23405,172508,372634,0.6371293155331837
5264,Sierra Leone,SLE,2011,706052,216526,28651,209469,454646,0.6439270761926884
5265,Sierra Leone,SLE,2003,545905,165015,21880,161163,348058,0.637579798682921
5266,Sierra Leone,SLE,2004,566492,171175,22688,167158,361021,0.637292318338123
5267,Sierra Leone,SLE,1990,377874,116808,15773,113245,245826,0.6505501833944648
5268,Sierra Leone,SLE,1992,370721,114187,15360,111634,241181,0.6505728027276577
5269,Sierra Leone,SLE,1993,378286,116468,15647,113812,245927,0.6501086479541934
5270,Sierra Leone,SLE,1994,383727,118039,15825,115449,249313,0.6497145105765296
5271,Sierra Leone,SLE,1995,392642,120741,16160,118004,254905,0.6492046189658773
5272,Sierra Leone,SLE,1996,399823,122709,16379,120097,259185,0.6482493503375244
5273,Sierra Leone,SLE,1991,369009,113796,15330,111011,240137,0.6507619055361793
5274,Sierra Leone,SLE,1998,416195,126620,16775,124618,268013,0.6439601629044078
5275,Sierra Leone,SLE,1999,439718,133323,17640,131003,281966,0.6412427965195876
5276,Sierra Leone,SLE,2000,466891,141353,18707,138593,298653,0.6396632190382766
5277,Sierra Leone,SLE,2001,495143,149840,19851,146555,316246,0.6386962958175719
5278,Sierra Leone,SLE,1997,402944,123092,16360,120999,260451,0.6463702152160101
5279,Sierra Leone,SLE,2002,521950,157831,20925,154220,332976,0.6379461634256155
5280,Singapore,SGP,1994,0,101267,27389,103607,232263,inf
5281,Singapore,SGP,2002,0,125244,34034,112918,272196,inf
5282,Singapore,SGP,2001,0,123702,33617,117396,274715,inf
5283,Singapore,SGP,1991,0,93220,25047,95966,214233,inf
5284,Singapore,SGP,2000,0,120187,32701,117318,270206,inf
5285,Singapore,SGP,1990,0,90675,24306,93361,208342,inf
5286,Singapore,SGP,1998,0,116073,31764,116041,263878,inf
5287,Singapore,SGP,1997,0,111947,30610,113013,255570,inf
5288,Singapore,SGP,1996,0,108224,29520,109911,247655,inf
5289,Singapore,SGP,1995,0,104249,28284,106350,238883,inf
5290,Singapore,SGP,2003,0,123979,33709,105325,263013,inf
5291,Singapore,SGP,1999,0,117723,32100,116423,266246,inf
5292,Singapore,SGP,2004,0,126043,34398,101284,261725,inf
5293,Singapore,SGP,2010,0,152195,43632,117236,313063,inf
5294,Singapore,SGP,2006,0,133624,36811,102604,273039,inf
5295,Singapore,SGP,2007,0,138813,38655,106050,283518,inf
5296,Singapore,SGP,2008,0,145554,41106,111330,297990,inf
5297,Singapore,SGP,2009,0,149630,42653,114859,307142,inf
5298,Singapore,SGP,2017,0,162804,47372,127399,337575,inf
5299,Singapore,SGP,2011,0,155042,44615,119646,319303,inf
5300,Singapore,SGP,2012,0,157978,45671,121945,325594,inf
5301,Singapore,SGP,2013,0,159388,46278,122908,328574,inf
5302,Singapore,SGP,2014,0,160485,46716,123655,330856,inf
5303,Singapore,SGP,2015,0,161690,47118,124581,333389,inf
5304,Singapore,SGP,2016,0,163067,47559,126748,337374,inf
5305,Singapore,SGP,1993,0,98317,26509,100867,225693,inf
5306,Singapore,SGP,2005,0,129467,35462,100642,265571,inf
5307,Singapore,SGP,1992,0,96015,25844,98665,220524,inf
5308,Singapore,SGP,2019,0,163602,47323,131234,342159,inf
5309,Singapore,SGP,2018,0,163202,47348,128660,339210,inf
5310,Slovakia,SVK,2019,624456,209758,34103,185321,429182,0.6872894167083029
5311,Slovakia,SVK,1990,593031,190031,30010,164002,384043,0.6475934647598524
5312,Slovakia,SVK,1991,597659,191537,30268,165416,387221,0.647896208373002
5313,Slovakia,SVK,1992,601847,193058,30538,166711,390307,0.6485153203388901
5314,Slovakia,SVK,1993,606128,194598,30825,168185,393608,0.6493809888340416
5315,Slovakia,SVK,1994,610078,196128,31120,169646,396894,0.6505627149315334
5316,Slovakia,SVK,1995,613878,197602,31406,171178,400186,0.6518982599148365
5317,Slovakia,SVK,1996,617412,199060,31688,172676,403424,0.653411336352387
5318,Slovakia,SVK,1998,623306,201828,32236,175471,409535,0.6570368326311635
5319,Slovakia,SVK,1999,625247,203043,32499,176727,412269,0.6593698170483026
5320,Slovakia,SVK,2000,627104,204141,32752,177882,414775,0.6614134178700821
5321,Slovakia,SVK,2001,628874,205146,32993,179000,417139,0.6633109335097332
5322,Slovakia,SVK,2002,630203,206070,33216,180090,419376,0.6654617639078202
5323,Slovakia,SVK,2018,623593,209144,34168,184537,427849,0.6861029549722335
5324,Slovakia,SVK,2003,631223,206905,33425,180966,421296,0.6674281513823166
5325,Slovakia,SVK,2005,631901,208138,33788,182428,424354,0.6715513980829275
5326,Slovakia,SVK,2006,631421,208566,33938,182907,425411,0.6737359067880225
5327,Slovakia,SVK,2007,630604,208894,34065,183158,426117,0.6757283493285802
5328,Slovakia,SVK,2008,629577,209166,34171,183293,426630,0.6776454667181298
5329,Slovakia,SVK,2009,628756,209392,34251,183427,427070,0.679230098798262
5330,Slovakia,SVK,2010,627909,209573,34306,183571,427450,0.6807515101710598
5331,Slovakia,SVK,2011,627318,209666,34342,183732,427740,0.6818551356728166
5332,Slovakia,SVK,2012,626241,209660,34362,183488,427510,0.6826605092927484
5333,Slovakia,SVK,2013,625244,209668,34372,183208,427248,0.6833300279570855
5334,Slovakia,SVK,2014,624637,209732,34369,183085,427186,0.6838948061033848
5335,Slovakia,SVK,2015,624297,209808,34341,183089,427238,0.684350557507084
5336,Slovakia,SVK,2016,623839,209364,34292,183453,427109,0.6846461987788516
5337,Slovakia,SVK,2017,623404,208920,34232,183944,427096,0.6851030792231041
5338,Slovakia,SVK,2004,631735,207595,33617,181719,422931,0.6694753338029396
5339,Slovakia,SVK,1997,620481,200490,31965,174082,406537,0.6551965330122921
5340,Slovenia,SVN,2000,249925,76317,12650,87371,176338,0.7055636691007302
5341,Slovenia,SVN,1996,249838,75128,12392,87788,175308,0.7016866929770491
5342,Slovenia,SVN,2018,249412,79175,12946,85156,177277,0.7107797539813642
5343,Slovenia,SVN,2017,249155,78974,12983,85092,177049,0.710597820633742
5344,Slovenia,SVN,2016,248829,79084,13013,84591,176688,0.7100780053771868
5345,Slovenia,SVN,2015,248460,79206,13035,84086,176327,0.7096796264992353
5346,Slovenia,SVN,2014,248229,79128,13053,83999,176180,0.7097478537962929
5347,Slovenia,SVN,2013,248110,79036,13068,84058,176162,0.710015718834388
5348,Slovenia,SVN,2012,248152,78939,13079,84256,176274,0.7103468841677681
5349,Slovenia,SVN,2011,248200,78814,13080,84488,176382,0.7106446414182112
5350,Slovenia,SVN,2010,248142,78660,13068,84682,176410,0.7109235840768592
5351,Slovenia,SVN,2009,248277,78498,13049,85014,176561,0.7111452128066635
5352,Slovenia,SVN,2008,248725,78324,13023,85603,176950,0.7114282842496733
5353,Slovenia,SVN,2007,249241,78138,12992,86295,177425,0.7118612106354893
5354,Slovenia,SVN,2006,249704,77932,12954,86888,177774,0.7119389356998687
5355,Slovenia,SVN,2005,249844,77713,12910,87218,177841,0.7118081682970173
5356,Slovenia,SVN,2004,249838,77466,12864,87324,177654,0.7110767777519833
5357,Slovenia,SVN,2003,249953,77181,12814,87410,177405,0.7097534336455253
5358,Slovenia,SVN,2002,249915,76877,12762,87401,177040,0.708400856291139
5359,Slovenia,SVN,2001,249947,76584,12707,87387,176678,0.7068618547131992
5360,Slovenia,SVN,1999,249943,76052,12590,87443,176085,0.7045006261427605
5361,Slovenia,SVN,1998,250063,75764,12528,87660,175952,0.703630685067363
5362,Slovenia,SVN,1997,250097,75454,12463,87856,175773,0.7028193061092296
5363,Slovenia,SVN,1995,249137,74786,12317,87454,174557,0.7006466321742656
5364,Slovenia,SVN,1994,248109,74424,12242,86887,173553,0.6995030410021402
5365,Slovenia,SVN,1993,246959,74025,12162,86308,172495,0.6984762652909997
5366,Slovenia,SVN,1992,245614,73595,12080,85674,171349,0.697635313947902
5367,Slovenia,SVN,1991,244035,73142,11994,84962,170098,0.6970229680168828
5368,Slovenia,SVN,1990,242278,72678,11911,84174,168763,0.6965675793922684
5369,Slovenia,SVN,2019,249578,79592,12908,84967,177467,0.7110682832621465
5370,Solomon Islands,SLB,1990,36589,11517,658,7586,19761,0.5400803520183661
5371,Solomon Islands,SLB,1991,37772,11921,683,7872,20476,0.5420946733029758
5372,Solomon Islands,SLB,1992,38957,12327,708,8164,21199,0.5441640783427882
5373,Solomon Islands,SLB,1995,42526,13553,785,9036,23374,0.5496402201006443
5374,Solomon Islands,SLB,1996,43715,13970,811,9329,24110,0.5515269358343818
5375,Solomon Islands,SLB,1997,44906,14400,836,9614,24850,0.5533781677281432
5376,Solomon Islands,SLB,1998,46103,14833,862,9894,25589,0.5550398021820706
5377,Solomon Islands,SLB,1999,47288,15256,887,10169,26312,0.556420233463035
5378,Solomon Islands,SLB,2000,48457,15656,912,10443,27011,0.5574220442866872
5379,Solomon Islands,SLB,2001,49680,16019,937,10718,27674,0.5570450885668277
5380,Solomon Islands,SLB,2002,50981,16353,961,10984,28298,0.5550695357093819
5381,Solomon Islands,SLB,2003,52328,16676,986,11243,28905,0.5523811343831219
5382,Solomon Islands,SLB,2004,53665,17008,1010,11503,29521,0.5500978291251281
5383,Solomon Islands,SLB,2005,54923,17370,1034,11768,30172,0.5493509094550553
5384,Solomon Islands,SLB,2006,56148,17780,1059,12036,30875,0.549886015530384
5385,Solomon Islands,SLB,2007,57396,18229,1083,12292,31604,0.5506307059725416
5386,Solomon Islands,SLB,2008,58649,18702,1108,12560,32370,0.5519275690975123
5387,Solomon Islands,SLB,2009,59945,19183,1134,12827,33144,0.5529068312619901
5388,Solomon Islands,SLB,2010,61247,19653,1159,13111,33923,0.5538720263849658
5389,Solomon Islands,SLB,2011,62554,20124,1186,13411,34721,0.5550564312434056
5390,Solomon Islands,SLB,2012,63816,20616,1213,13723,35552,0.5571016672934688
5391,Solomon Islands,SLB,2013,65093,21120,1241,14041,36402,0.5592306392392423
5392,Solomon Islands,SLB,2014,66365,21627,1270,14367,37264,0.5615007910796354
5393,Solomon Islands,SLB,2015,67669,22129,1300,14706,38135,0.5635519957439892
5394,Solomon Islands,SLB,2016,68962,22587,1330,15040,38957,0.5649053101708187
5395,Solomon Islands,SLB,2017,70282,23050,1361,15378,39789,0.566133576164594
5396,Solomon Islands,SLB,2018,71740,23589,1392,15754,40735,0.5678143295232785
5397,Solomon Islands,SLB,2019,73286,24185,1425,16150,41760,0.5698223398739186
5398,Solomon Islands,SLB,1994,41324,13145,759,8745,22649,0.5480834381957216
5399,Solomon Islands,SLB,1993,40145,12736,733,8453,21922,0.5460704944575913
5400,Somalia,SOM,1992,898571,207523,33439,244904,485866,0.5407096378583328
5401,Somalia,SOM,2019,2507572,553845,91618,653844,1299307,0.5181534169308
5402,Somalia,SOM,1993,939351,216537,35046,255437,507020,0.5397556397981159
5403,Somalia,SOM,1994,979367,225223,36599,265655,527477,0.5385897217284226
5404,Somalia,SOM,1995,1022147,234296,38191,276410,548897,0.537003973009753
5405,Somalia,SOM,1996,1066579,243326,39785,287499,570610,0.5349908445600373
5406,Somalia,SOM,1997,1116953,253420,41600,299735,594755,0.5324798805321262
5407,Somalia,SOM,1998,1172566,264358,43564,313268,621190,0.5297697528326764
5408,Somalia,SOM,1999,1226962,275042,45446,326534,647022,0.5273366249321495
5409,Somalia,SOM,2000,1280306,285848,47274,339334,672456,0.5252306870388798
5410,Somalia,SOM,2001,1335894,297658,49188,352869,699715,0.5237803298764723
5411,Somalia,SOM,2002,1393747,310181,51145,366764,728090,0.5223975369991828
5412,Somalia,SOM,2003,1450639,322571,53023,380478,756072,0.5211992783869729
5413,Somalia,SOM,2004,1505616,334504,54790,393470,782764,0.5198961753860214
5414,Somalia,SOM,1991,856256,198109,31794,234250,464153,0.5420726978847448
5415,Somalia,SOM,2005,1561458,346559,56589,406459,809607,0.5184942534477393
5416,Somalia,SOM,2007,1669291,369232,60217,431421,860870,0.5157099630921151
5417,Somalia,SOM,2008,1718168,379301,61893,442355,883549,0.5142390034036253
5418,Somalia,SOM,2009,1762156,388309,63370,452396,904075,0.5130504904219604
5419,Somalia,SOM,2010,1801984,396699,64684,461849,923232,0.5123419519818156
5420,Somalia,SOM,2011,1853840,408209,66533,475740,950482,0.512709834721443
5421,Somalia,SOM,2012,1920677,423004,69012,493636,985652,0.5131794674481966
5422,Somalia,SOM,2013,1991774,438867,71709,513612,1024188,0.514208941375879
5423,Somalia,SOM,2014,2066710,455746,74599,534315,1064660,0.5151472630412588
5424,Somalia,SOM,2015,2150152,474723,77858,557051,1109632,0.51607142192738
5425,Somalia,SOM,2016,2237694,494802,81324,581085,1157211,0.5171444352981238
5426,Somalia,SOM,2017,2325512,514608,84747,605054,1204409,0.5179113244739223
5427,Somalia,SOM,2018,2414154,534166,88150,628929,1251245,0.5182954359995261
5428,Somalia,SOM,2006,1617483,358539,58467,419801,836807,0.5173513415596949
5429,Somalia,SOM,1990,842420,195265,31306,230674,457245,0.5427755751287956
5430,South Africa,ZAF,2019,6512562,2150511,320843,2390738,4862092,0.7465713186300568
5431,South Africa,ZAF,2003,5267331,1816140,256177,1720073,3792390,0.7199832324947872
5432,South Africa,ZAF,2014,6069801,2029832,301714,2168633,4500179,0.7414047017356912
5433,South Africa,ZAF,2013,5976794,2003121,297667,2119378,4420166,0.7395546843341095
5434,South Africa,ZAF,2012,5884499,1976660,293565,2069893,4340118,0.7375509792762307
5435,South Africa,ZAF,2011,5798643,1951492,289485,2022537,4263514,0.7352606463270803
5436,South Africa,ZAF,2010,5719710,1928405,285480,1979152,4193037,0.7330855935003697
5437,South Africa,ZAF,2009,5649020,1910843,281482,1936212,4128537,0.7308412786642638
5438,South Africa,ZAF,2008,5584113,1899803,277478,1890885,4068166,0.7285250137309184
5439,South Africa,ZAF,2007,5523069,1891431,273448,1847030,4011909,0.7263912509512375
5440,South Africa,ZAF,2006,5462462,1881459,269376,1805908,3956743,0.7243515835899637
5441,South Africa,ZAF,2005,5399326,1864809,265192,1770945,3900946,0.7224875845614804
5442,South Africa,ZAF,2004,5334217,1841765,260793,1742858,3845416,0.720896056534633
5443,South Africa,ZAF,2017,6377252,2110021,313174,2342337,4765532,0.7472704544214341
5444,South Africa,ZAF,2015,6161934,2055891,305651,2216103,4577645,0.7428909494973494
5445,South Africa,ZAF,2002,5194300,1787358,251292,1697921,3736571,0.7193598752478678
5446,South Africa,ZAF,2001,5111191,1755125,246127,1672721,3673973,0.7188095690417361
5447,South Africa,ZAF,2000,5015997,1719807,240781,1641441,3602029,0.7181082843550345
5448,South Africa,ZAF,1999,4907490,1677987,235297,1605663,3518947,0.7170563770888988
5449,South Africa,ZAF,1998,4789295,1629494,229746,1568397,3427637,0.7156871731643175
5450,South Africa,ZAF,1997,4669166,1579278,224207,1531110,3334595,0.7141735804638344
5451,South Africa,ZAF,1996,4548877,1530930,218613,1493441,3242984,0.7129196942454149
5452,South Africa,ZAF,1995,4434707,1488479,213048,1456439,3157966,0.71210251319873
5453,South Africa,ZAF,1994,4328759,1450785,207619,1423135,3081539,0.7118758517163927
5454,South Africa,ZAF,1993,4229207,1414028,202281,1395116,3011425,0.712054292920635
5455,South Africa,ZAF,1992,4135508,1378506,197064,1371010,2946580,0.7125073872423896
5456,South Africa,ZAF,1991,4045752,1344211,191941,1349551,2885703,0.7132673975073114
5457,South Africa,ZAF,1990,3958562,1311007,186865,1329004,2826876,0.7141168939630098
5458,South Africa,ZAF,2018,6451600,2132099,316958,2372915,4821972,0.7474071548143096
5459,South Africa,ZAF,2016,6271840,2083254,309440,2281760,4674454,0.7453082349039516
5460,South Asia (WB),,1991,148281673,30256327,3536942,38224302,72017571,0.4856808636088156
5461,South Asia (WB),,1990,144428840,29680292,3452080,36209608,69341980,0.4801117283777949
5462,South Asia (WB),,2004,193254429,38010388,4832845,55629551,98472784,0.5095499467181681
5463,South Asia (WB),,2017,238737146,56316769,6532399,65126543,127975711,0.5360527808269937
5464,South Asia (WB),,2019,244470015,57337691,6809448,67689067,131836206,0.5392735219491028
5465,South Asia (WB),,2015,231372108,53907271,6255907,62201412,122364590,0.5288649140025123
5466,South Asia (WB),,2014,227559067,52674987,6119498,60764172,119558657,0.5253961469265472
5467,South Asia (WB),,2013,223575174,51399683,5984160,59326033,116709876,0.5220162592828844
5468,South Asia (WB),,2012,219504016,50090797,5848560,57918762,113858119,0.5187063137833433
5469,South Asia (WB),,2011,215448412,48776943,5714304,56560670,111051917,0.5154455118471701
5470,South Asia (WB),,2010,211495619,47475092,5581561,55283676,108340329,0.5122580293258935
5471,South Asia (WB),,2009,208219043,45945128,5450224,54956649,106352001,0.5107698098487562
5472,South Asia (WB),,2008,205740311,44119338,5322444,55820365,105262147,0.5116262655984806
5473,South Asia (WB),,2007,203452294,42227040,5196566,56999576,104423182,0.5132563508966873
5474,South Asia (WB),,2006,200826952,40498725,5073162,57673046,103244933,0.5140989890639778
5475,South Asia (WB),,2005,197445424,39153560,4953026,57145793,101252379,0.5128119808945281
5476,South Asia (WB),,2003,188848090,36838747,4715113,53933341,95487201,0.5056296889208676
5477,South Asia (WB),,2002,184450470,35700528,4600129,52216123,92516780,0.5015806140260851
5478,South Asia (WB),,2001,180226521,34640770,4486655,50607204,89734629,0.4978991354995972
5479,South Asia (WB),,2000,176445254,33736533,4378811,49243747,87359091,0.49510592673691295
5480,South Asia (WB),,1999,173328807,33196601,4277305,48199041,85672947,0.4942799092824772
5481,South Asia (WB),,1998,170747150,33030028,4179922,47358544,84568494,0.4952849520475159
5482,South Asia (WB),,1997,168315135,32996384,4084263,46581451,83662098,0.4970562985913299
5483,South Asia (WB),,1996,165729420,32878897,3988849,45749678,82617424,0.4985078931670671
5484,South Asia (WB),,1995,162775933,32498015,3895302,44766941,81160258,0.4986010923371577
5485,South Asia (WB),,1994,159463033,31942686,3805194,43515443,79263323,0.497063937069352
5486,South Asia (WB),,1993,155945233,31405191,3717627,41964520,77087338,0.49432314484406203
5487,South Asia (WB),,1992,152190568,30844539,3627879,40175712,74648130,0.4904911715685298
5488,South Asia (WB),,2018,241884983,57063008,6670855,66484046,130217909,0.5383463966425729
5489,South Asia (WB),,2016,235089096,55136691,6393779,63657271,125187741,0.5325118992333018
5490,South Korea,KOR,2017,0,1847482,315343,1330111,3492936,inf
5491,South Korea,KOR,2013,0,1915175,300867,1274025,3490067,inf
5492,South Korea,KOR,2016,0,1917178,312459,1329236,3558873,inf
5493,South Korea,KOR,2012,0,1866866,296690,1247633,3411189,inf
5494,South Korea,KOR,2011,0,1820749,292587,1220656,3333992,inf
5495,South Korea,KOR,2010,0,1782576,288477,1194214,3265267,inf
5496,South Korea,KOR,2009,0,1749113,284567,1166460,3200140,inf
5497,South Korea,KOR,2008,0,1714722,280967,1134698,3130387,inf
5498,South Korea,KOR,2007,0,1682319,277542,1103678,3063539,inf
5499,South Korea,KOR,2006,0,1655373,274322,1076038,3005733,inf
5500,South Korea,KOR,2005,0,1635955,271342,1055548,2962845,inf
5501,South Korea,KOR,2004,0,1636246,268013,1039524,2943783,inf
5502,South Korea,KOR,2003,0,1657780,264117,1024712,2946609,inf
5503,South Korea,KOR,2015,0,1983115,308949,1322605,3614669,inf
5504,South Korea,KOR,2001,0,1711812,256473,997605,2965890,inf
5505,South Korea,KOR,2000,0,1719422,253693,985309,2958424,inf
5506,South Korea,KOR,1999,0,1700862,251484,972543,2924889,inf
5507,South Korea,KOR,1998,0,1663208,249194,959373,2871775,inf
5508,South Korea,KOR,1997,0,1618226,246797,946587,2811610,inf
5509,South Korea,KOR,1996,0,1578628,244291,935143,2758062,inf
5510,South Korea,KOR,1995,0,1556373,241746,925703,2723822,inf
5511,South Korea,KOR,1994,0,1548518,239326,918435,2706279,inf
5512,South Korea,KOR,1993,0,1540444,236941,913525,2690910,inf
5513,South Korea,KOR,1992,0,1530446,234470,908488,2673404,inf
5514,South Korea,KOR,1991,0,1517532,231453,902358,2651343,inf
5515,South Korea,KOR,1990,0,1500798,227871,895157,2623826,inf
5516,South Korea,KOR,2014,0,1957095,304945,1299369,3561409,inf
5517,South Korea,KOR,2002,0,1686917,260076,1010657,2957650,inf
5518,South Korea,KOR,2019,0,1862219,320364,1347881,3530464,inf
5519,South Korea,KOR,2018,0,1855023,318018,1339993,3513034,inf
5520,South Sudan,SSD,2017,955837,370872,42025,291586,704483,0.7370325693606755
5521,South Sudan,SSD,2018,987824,382796,43625,302390,728811,0.7377943844247559
5522,South Sudan,SSD,2019,1015880,391805,45089,313213,750107,0.7383815017521754
5523,South Sudan,SSD,2014,1023702,396490,45581,308558,750629,0.7332495198798088
5524,South Sudan,SSD,2013,1030639,398390,46119,310253,754762,0.7323243153034186
5525,South Sudan,SSD,2012,1028131,396480,46219,309258,751957,0.7313824794700287
5526,South Sudan,SSD,2011,1011022,388767,45563,304046,738376,0.7303263430469367
5527,South Sudan,SSD,2010,983385,377383,44355,295616,717354,0.7294742140667185
5528,South Sudan,SSD,2009,957197,366809,43181,287937,697927,0.7291362175184418
5529,South Sudan,SSD,2008,931810,356717,42051,280623,679391,0.7291089385175089
5530,South Sudan,SSD,2007,908005,347125,40971,273660,661756,0.7288021541731599
5531,South Sudan,SSD,2006,884902,338040,39945,267149,645134,0.7290457022359538
5532,South Sudan,SSD,2005,862801,329386,38970,260584,628940,0.7289514036260969
5533,South Sudan,SSD,2004,841462,320999,38041,254443,613483,0.7290679793026899
5534,South Sudan,SSD,2003,821128,312846,37158,248639,598643,0.7290495513488762
5535,South Sudan,SSD,2002,801586,305017,36318,243038,584373,0.7290209659350338
5536,South Sudan,SSD,2001,783135,297598,35516,237759,570873,0.7289586086690034
5537,South Sudan,SSD,2000,765606,290697,34754,232610,558061,0.7289140889700446
5538,South Sudan,SSD,1999,749229,284240,34030,227788,546058,0.7288265670442549
5539,South Sudan,SSD,1998,733524,278091,33344,223204,534639,0.7288636772620937
5540,South Sudan,SSD,1997,718969,272270,32696,218957,523923,0.7287143117436218
5541,South Sudan,SSD,1996,704536,266595,32055,214742,513392,0.7286951979742696
5542,South Sudan,SSD,1995,690316,261029,31414,210538,502981,0.7286242822127837
5543,South Sudan,SSD,1994,676428,255671,30791,206414,492876,0.7286451773137718
5544,South Sudan,SSD,1993,663080,250454,30184,202360,482998,0.7284158774205224
5545,South Sudan,SSD,1992,649994,245371,29595,198523,473489,0.7284513395508266
5546,South Sudan,SSD,1991,637122,240431,29019,194803,464253,0.7286720596683209
5547,South Sudan,SSD,1990,624893,235630,28457,191269,455356,0.7286943524731434
5548,South Sudan,SSD,2016,946166,366543,41568,287655,695766,0.7353529930265936
5549,South Sudan,SSD,2015,985222,381605,43550,298141,723296,0.7341451977320848
5550,South-East Asia Region (WHO),,2017,253562328,63499346,7016113,68232488,138747947,0.5471946408379718
5551,South-East Asia Region (WHO),,2019,258190828,64387809,7269184,70537372,142194365,0.5507336031317116
5552,South-East Asia Region (WHO),,1991,168144431,36711959,4020888,41250671,81983518,0.48757795612035465
5553,South-East Asia Region (WHO),,2015,247108544,61175893,6760478,65481574,133417945,0.5399163575663333
5554,South-East Asia Region (WHO),,2014,243674044,59970970,6631230,64087687,130689887,0.5363307673426226
5555,South-East Asia Region (WHO),,2013,240090747,58717363,6502492,62687099,127906954,0.5327442044236715
5556,South-East Asia Region (WHO),,2012,236430428,57433979,6374408,61310092,125118479,0.529197870419623
5557,South-East Asia Region (WHO),,2011,232776818,56138506,6247008,59978571,122364085,0.5256712676603389
5558,South-East Asia Region (WHO),,2010,229192461,54849696,6120535,58724359,119694590,0.5222448830897627
5559,South-East Asia Region (WHO),,2009,226362255,53345973,5997238,58436020,117779231,0.5203130309865486
5560,South-East Asia Region (WHO),,2008,224388209,51554115,5878581,59350685,116783381,0.5204523959634617
5561,South-East Asia Region (WHO),,2007,222389870,49637855,5755504,60534010,115927369,0.5212798991249017
5562,South-East Asia Region (WHO),,2006,219809139,47827991,5627636,61166240,114621867,0.5214608797498633
5563,South-East Asia Region (WHO),,2005,216500825,46425669,5503650,60607800,112537119,0.5197999545729214
5564,South-East Asia Region (WHO),,1990,164224071,36032104,3929813,39176494,79138411,0.48189288280400744
5565,South-East Asia Region (WHO),,2004,212509907,45276934,5383800,59091838,109752572,0.5164586138565295
5566,South-East Asia Region (WHO),,2002,204046465,42961707,5150158,55662910,103774775,0.5085840374642119
5567,South-East Asia Region (WHO),,2001,200010013,41901527,5036797,54051484,100989808,0.504923760991906
5568,South-East Asia Region (WHO),,2000,196323867,40963628,4925465,52665011,98554104,0.5019975691493485
5569,South-East Asia Region (WHO),,1999,193218514,40353501,4816512,51580067,96750080,0.500728827673315
5570,South-East Asia Region (WHO),,1998,190620262,40097096,4709721,50691673,95498490,0.50098813734712
5571,South-East Asia Region (WHO),,1997,188193324,39972634,4605167,49873483,94451284,0.5018843495213464
5572,South-East Asia Region (WHO),,1996,185632170,39770429,4502242,49004174,93276845,0.5024821128794648
5573,South-East Asia Region (WHO),,1995,182664466,39303233,4401067,47974293,91678593,0.5018961542306756
5574,South-East Asia Region (WHO),,1994,179302511,38653931,4302920,46666149,89623000,0.49984241436529575
5575,South-East Asia Region (WHO),,1993,175718073,38011463,4206957,45054811,87273231,0.496666219416144
5576,South-East Asia Region (WHO),,1992,171981754,37367548,4113037,43227485,84708070,0.4925410285093383
5577,South-East Asia Region (WHO),,2003,208280636,44103282,5265834,57388273,106757389,0.512565119111697
5578,South-East Asia Region (WHO),,2016,250392193,62368618,6888532,66859775,136116925,0.5436148921783676
5579,South-East Asia Region (WHO),,2018,256190266,64182736,7143063,69477886,140803685,0.5496059128179367
5580,Spain,ESP,2018,8089435,2539306,489282,2608760,5637348,0.6968778412831057
5581,Spain,ESP,2019,7921378,2360298,487980,2629831,5478109,0.6915601048201462
5582,Spain,ESP,2016,8189786,2633432,492468,2578686,5704586,0.6965488475523048
5583,Spain,ESP,2015,8202451,2639910,494494,2565141,5699545,0.6948587684339718
5584,Spain,ESP,2014,8217710,2646106,496589,2556546,5699241,0.6935315312903473
5585,Spain,ESP,2013,8227322,2650966,498880,2544188,5694034,0.6920883855038128
5586,Spain,ESP,2012,8227807,2651648,500534,2526891,5679073,0.6902292433451587
5587,Spain,ESP,2011,8202343,2644445,501132,2499652,5645229,0.6882459072974637
5588,Spain,ESP,2010,8148678,2627760,500337,2462794,5590891,0.6861101886710949
5589,Spain,ESP,2009,8030034,2571765,497623,2398727,5468115,0.6809578888458007
5590,Spain,ESP,2008,7833145,2465615,493170,2305327,5264112,0.6720304552003059
5591,Spain,ESP,2007,7598610,2336136,487340,2201221,5024697,0.6612652840453714
5592,Spain,ESP,2006,7373592,2211620,481097,2108021,4800738,0.6510718249667191
5593,Spain,ESP,2005,7191628,2115729,474440,2039997,4630166,0.643827239117485
5594,Spain,ESP,1990,6459799,1911717,394343,1763948,4070008,0.6300518019213911
5595,Spain,ESP,2004,7034366,2038253,466910,1987348,4492511,0.6386518699766262
5596,Spain,ESP,2003,6871855,1961084,458796,1932025,4351905,0.63329406688587
5597,Spain,ESP,2002,6715122,1890938,450401,1878144,4219483,0.6283553746305726
5598,Spain,ESP,2001,6584440,1836898,442440,1833031,4112369,0.6245586564688873
5599,Spain,ESP,2000,6493577,1806911,435548,1801593,4044052,0.6227772458846642
5600,Spain,ESP,1999,6450951,1814742,429924,1781074,4025740,0.624053724791895
5601,Spain,ESP,1998,6442945,1855200,425094,1764162,4044456,0.6277340563981223
5602,Spain,ESP,1997,6453259,1906353,420700,1751204,4078257,0.6319685913737539
5603,Spain,ESP,1996,6463953,1948410,416642,1740480,4105532,0.6351426131965997
5604,Spain,ESP,1995,6463095,1961947,412835,1732205,4106987,0.6354520550912527
5605,Spain,ESP,1994,6456231,1954778,409177,1729390,4093345,0.6340146441476459
5606,Spain,ESP,1993,6454107,1947278,405526,1731246,4084050,0.6327831255354149
5607,Spain,ESP,1992,6457194,1938329,401898,1739155,4079382,0.6317576953704659
5608,Spain,ESP,1991,6458504,1926658,398131,1750209,4074998,0.63095075887543
5609,Spain,ESP,2017,8177851,2626024,490793,2594129,5710946,0.6983431221723164
5610,Sri Lanka,LKA,2018,2474119,923039,78597,674372,1676008,0.6774160822498837
5611,Sri Lanka,LKA,2017,2453265,911568,77783,665920,1655271,0.6747216464589028
5612,Sri Lanka,LKA,1991,2041840,643745,55480,552130,1251355,0.6128565411589547
5613,Sri Lanka,LKA,2015,2408403,884937,76169,650019,1611125,0.668959887527129
5614,Sri Lanka,LKA,2014,2386706,873069,75377,641399,1589845,0.666125195143432
5615,Sri Lanka,LKA,2013,2364977,860906,74589,632213,1567708,0.6628850935971048
5616,Sri Lanka,LKA,2012,2343299,848800,73803,622633,1545236,0.6594275847853817
5617,Sri Lanka,LKA,2011,2322828,837111,73015,614092,1524218,0.6561906434742478
5618,Sri Lanka,LKA,2010,2304319,826261,72240,606332,1504833,0.6530489051212094
5619,Sri Lanka,LKA,2009,2288791,815686,71475,601099,1488260,0.6502384883547689
5620,Sri Lanka,LKA,2008,2276163,804781,70712,597962,1473455,0.6473416007553062
5621,Sri Lanka,LKA,2007,2263835,793854,69931,595906,1459691,0.6447868329626497
5622,Sri Lanka,LKA,2006,2251565,783434,69135,594364,1446933,0.6426343454441689
5623,Sri Lanka,LKA,2005,2238980,774025,68327,592519,1434871,0.6408592305424792
5624,Sri Lanka,LKA,2004,2227863,766126,67566,591280,1424972,0.6396138362188339
5625,Sri Lanka,LKA,2003,2216420,758546,66789,590573,1415908,0.6388265761904333
5626,Sri Lanka,LKA,2019,2495793,934474,79411,683084,1696969,0.6799317892148908
5627,Sri Lanka,LKA,2002,2202456,750390,65928,589491,1405809,0.6382915254606676
5628,Sri Lanka,LKA,2001,2189570,742153,65050,588659,1395862,0.6375050809062967
5629,Sri Lanka,LKA,2000,2178476,733767,64170,587720,1385657,0.6360671405147452
5630,Sri Lanka,LKA,1999,2169897,725072,63278,588609,1376959,0.6345734382784067
5631,Sri Lanka,LKA,1998,2163529,716051,62361,590839,1369251,0.6328785054418037
5632,Sri Lanka,LKA,1997,2156928,706822,61433,592873,1361128,0.6310493442525666
5633,Sri Lanka,LKA,1996,2147344,697302,60482,592436,1350220,0.6287860724690595
5634,Sri Lanka,LKA,1995,2131794,687453,59505,587198,1334156,0.6258372056587082
5635,Sri Lanka,LKA,1994,2111364,677106,58502,578875,1314483,0.6225752641420428
5636,Sri Lanka,LKA,1993,2089398,666168,57476,570291,1293935,0.6192860335847933
5637,Sri Lanka,LKA,1992,2065682,654989,56463,561021,1272473,0.6160062391016623
5638,Sri Lanka,LKA,1990,2016439,632495,54524,542192,1229211,0.6095949344364
5639,Sri Lanka,LKA,2016,2430946,898391,76970,658118,1633479,0.6719519890610487
5640,Sub-Saharan Africa (WB),,1990,53788915,15309326,2293417,16978272,34581015,0.642902259694214
5641,Sub-Saharan Africa (WB),,2006,85030647,24064003,3647174,27000238,54711415,0.643431714685177
5642,Sub-Saharan Africa (WB),,1993,58645665,16633566,2498053,18386098,37517717,0.6397355541965464
5643,Sub-Saharan Africa (WB),,1994,60443008,17127848,2574207,18924261,38626316,0.6390535030950147
5644,Sub-Saharan Africa (WB),,1995,62331809,17649907,2654327,19503415,39807649,0.6386410027021677
5645,Sub-Saharan Africa (WB),,1996,64345294,18199125,2738282,20161595,41099002,0.6387258406185851
5646,Sub-Saharan Africa (WB),,1997,66444088,18758459,2823125,20896229,42477813,0.6393016185277463
5647,Sub-Saharan Africa (WB),,1998,68537938,19314954,2907242,21650932,43873128,0.6401290917155984
5648,Sub-Saharan Africa (WB),,1999,70632829,19876654,2992331,22395857,45264842,0.6408470769307569
5649,Sub-Saharan Africa (WB),,2000,72680162,20445594,3079390,23080551,46605535,0.6412414848497449
5650,Sub-Saharan Africa (WB),,2001,74684303,21014751,3168653,23719123,47902527,0.6414002015925623
5651,Sub-Saharan Africa (WB),,2002,76679219,21581812,3259588,24357141,49198541,0.6416150508783873
5652,Sub-Saharan Africa (WB),,2003,78691648,22156032,3352323,25000403,50508758,0.6418566554864882
5653,Sub-Saharan Africa (WB),,2004,80748913,22750603,3447516,25659976,51858095,0.6422141558735286
5654,Sub-Saharan Africa (WB),,2005,82875734,23378008,3545770,26345492,53269270,0.6427607627583727
5655,Sub-Saharan Africa (WB),,2007,87181913,24816048,3751837,27587052,56154937,0.644112236904001
5656,Sub-Saharan Africa (WB),,2008,89355122,25612694,3860215,28145089,57617998,0.6448203159523412
5657,Sub-Saharan Africa (WB),,2009,91570235,26422232,3971673,28719990,59113895,0.6455579697922583
5658,Sub-Saharan Africa (WB),,2010,93854045,27213229,4086176,29360992,60660397,0.6463269324193752
5659,Sub-Saharan Africa (WB),,2011,96193070,27998527,4204867,30057633,62261027,0.6472506491371988
5660,Sub-Saharan Africa (WB),,2012,98566206,28810880,4328292,30770948,63910120,0.6483978900435713
5661,Sub-Saharan Africa (WB),,2013,100995853,29650443,4456070,31520793,65627306,0.6498019874142753
5662,Sub-Saharan Africa (WB),,2014,103551400,30522251,4588185,32344916,67455352,0.651419024754856
5663,Sub-Saharan Africa (WB),,2015,106318263,31435255,4725597,33292125,69452977,0.6532553772064542
5664,Sub-Saharan Africa (WB),,2016,109325554,32425443,4870192,34370229,71665864,0.6555271057670561
5665,Sub-Saharan Africa (WB),,2017,112481078,33448809,5022323,35502473,73973605,0.6576537699967634
5666,Sub-Saharan Africa (WB),,2018,115700836,34437452,5179976,36663124,76280552,0.6592912777224876
5667,Sub-Saharan Africa (WB),,1992,56999420,16181828,2428206,17904284,36514318,0.6406085886487968
5668,Sub-Saharan Africa (WB),,2019,118978857,35399049,5342733,37866985,78608767,0.6606952611756894
5669,Sub-Saharan Africa (WB),,1991,55400128,15746381,2360906,17441868,35549155,0.6416800156129603
5670,Sudan,SDN,1991,3185773,892851,125038,734442,1752331,0.5500489206230325
5671,Sudan,SDN,2017,5792738,1797766,255515,1454387,3507668,0.6055285082805402
5672,Sudan,SDN,2016,5649779,1751162,247473,1408788,3407423,0.6031073073831738
5673,Sudan,SDN,2015,5493164,1699676,238890,1360399,3298965,0.600558257499685
5674,Sudan,SDN,2014,5351372,1648430,231348,1318375,3198153,0.5976323454994346
5675,Sudan,SDN,2013,5229802,1600786,224758,1283712,3109256,0.5945265231838605
5676,Sudan,SDN,2012,5114419,1554776,218544,1251837,3025157,0.5914957300135167
5677,Sudan,SDN,2011,5010718,1513114,212878,1221888,2947880,0.5883148882056424
5678,Sudan,SDN,2010,4918776,1477331,207788,1194927,2880046,0.5855208694195466
5679,Sudan,SDN,2009,4839529,1445832,203093,1169833,2818758,0.5824446965810103
5680,Sudan,SDN,2008,4752381,1412228,198026,1143443,2753697,0.5794352346749977
5681,Sudan,SDN,2007,4653224,1375185,192420,1113621,2681226,0.576208237557444
5682,Sudan,SDN,2006,4553769,1338465,186896,1084777,2610138,0.5731819071191359
5683,Sudan,SDN,2018,5927935,1845991,262674,1499391,3608056,0.6086530975795112
5684,Sudan,SDN,2005,4460163,1303587,181730,1057709,2543026,0.5701643639481337
5685,Sudan,SDN,2004,4370318,1270251,176923,1032671,2479845,0.5674289605470357
5686,Sudan,SDN,2003,4290867,1239136,172534,1011034,2422704,0.5646187588662152
5687,Sudan,SDN,2002,4227012,1212957,168905,993478,2375340,0.561943046293694
5688,Sudan,SDN,2001,4169125,1189339,165670,977220,2332229,0.5594049111024496
5689,Sudan,SDN,2000,4093721,1162955,162020,956550,2281525,0.5573230320288071
5690,Sudan,SDN,1999,4004794,1133564,157956,932332,2223852,0.5552974759750439
5691,Sudan,SDN,1998,3910238,1103192,153795,905574,2162561,0.5530509907581073
5692,Sudan,SDN,1997,3813350,1072575,149597,878795,2100967,0.5509504766150498
5693,Sudan,SDN,1996,3706014,1040222,145122,851328,2036672,0.5495586363138402
5694,Sudan,SDN,1995,3604850,1010655,141050,826959,1978664,0.5488894128743221
5695,Sudan,SDN,1994,3516571,985774,137691,806809,1930274,0.5489080129478404
5696,Sudan,SDN,1993,3417452,957821,133899,784989,1876709,0.5491544577656101
5697,Sudan,SDN,1992,3306703,926575,129648,760587,1816810,0.5494324709536962
5698,Sudan,SDN,1990,3057857,857548,120165,707016,1684729,0.5509508783438859
5699,Sudan,SDN,2019,6068644,1899869,269787,1548239,3717895,0.6126401548682044
5700,Suriname,SUR,1991,56024,15251,3327,15863,34441,0.6147543909752963
5701,Suriname,SUR,2018,87250,24503,5370,28185,58058,0.6654212034383954
5702,Suriname,SUR,1992,56453,15375,3358,16049,34782,0.6161231466883956
5703,Suriname,SUR,1993,56896,15502,3388,16239,35129,0.6174247750281214
5704,Suriname,SUR,1994,57576,15698,3434,16498,35630,0.6188342364874253
5705,Suriname,SUR,1995,58747,16021,3509,16904,36434,0.6201848605035151
5706,Suriname,SUR,1996,60117,16402,3598,17395,37395,0.6220370277957982
5707,Suriname,SUR,1997,61629,16810,3697,17974,38481,0.624397605023609
5708,Suriname,SUR,1998,63214,17238,3802,18593,39633,0.6269655456069858
5709,Suriname,SUR,1999,64967,17707,3915,19262,40884,0.6293041082395677
5710,Suriname,SUR,2000,66850,18213,4035,19958,42206,0.6313537771129394
5711,Suriname,SUR,2001,68819,18747,4158,20678,43583,0.6332989436056903
5712,Suriname,SUR,2002,70883,19304,4285,21465,45054,0.6356107952541512
5713,Suriname,SUR,2003,72921,19856,4410,22247,46513,0.637854664637073
5714,Suriname,SUR,2019,87656,24717,5404,28275,58396,0.6661951264032125
5715,Suriname,SUR,2004,74773,20372,4527,22976,47875,0.6402712208952429
5716,Suriname,SUR,2006,77783,21255,4724,24143,50122,0.6443824486070221
5717,Suriname,SUR,2007,78930,21622,4801,24598,51021,0.6464082098061573
5718,Suriname,SUR,2008,79899,21954,4870,24988,51812,0.6484686917233007
5719,Suriname,SUR,2009,80776,22259,4931,25344,52534,0.6503664454788551
5720,Suriname,SUR,2010,81841,22606,5005,25764,53375,0.6521792255715351
5721,Suriname,SUR,2011,82951,22977,5082,26195,54254,0.6540487757832938
5722,Suriname,SUR,2012,83872,23309,5144,26567,55020,0.6559996184662342
5723,Suriname,SUR,2013,84598,23601,5194,26878,55673,0.6580888437078891
5724,Suriname,SUR,2014,85158,23836,5231,27139,56206,0.6600201977500646
5725,Suriname,SUR,2015,85702,24043,5268,27406,56717,0.6617931903572846
5726,Suriname,SUR,2016,86234,24183,5303,27703,57189,0.6631838949834172
5727,Suriname,SUR,2017,86755,24315,5337,27985,57637,0.6643651662728373
5728,Suriname,SUR,2005,76404,20835,4631,23613,49079,0.6423616564577771
5729,Suriname,SUR,1990,55696,15156,3303,15721,34180,0.6136885952312554
5730,Sweden,SWE,2019,1507628,508955,110497,482156,1101608,0.7306895334923469
5731,Sweden,SWE,2018,1492239,505008,109742,479878,1094628,0.7335473741136641
5732,Sweden,SWE,2017,1479004,501141,108976,477248,1087365,0.7352008513837691
5733,Sweden,SWE,2016,1467814,497852,108197,474222,1080271,0.7359726777370975
5734,Sweden,SWE,2015,1456010,494209,107402,471157,1072768,0.7367861484467827
5735,Sweden,SWE,2014,1444019,489116,106597,469151,1064864,0.7374307401772414
5736,Sweden,SWE,2013,1433200,483337,105800,468579,1057716,0.7380100474462741
5737,Sweden,SWE,2012,1422741,477518,105008,468150,1050676,0.7384871877594025
5738,Sweden,SWE,2011,1412823,472260,104225,467093,1043578,0.7386473747950026
5739,Sweden,SWE,2009,1393442,464887,102597,460541,1028025,0.7377594474689294
5740,Sweden,SWE,2008,1383633,462178,101746,455658,1019582,0.7368875995296441
5741,Sweden,SWE,2007,1374236,459777,100897,450620,1011294,0.7358954357184646
5742,Sweden,SWE,2006,1365545,457547,100064,445902,1003513,0.7348809449706893
5743,Sweden,SWE,2005,1357293,455228,99252,441662,996142,0.7339181738946565
5744,Sweden,SWE,2004,1349609,452716,98400,438101,989217,0.732965621894934
5745,Sweden,SWE,2010,1403167,468068,103427,464643,1036138,0.7384281414828028
5746,Sweden,SWE,2002,1335139,447642,96686,432189,976517,0.7313972552670546
5747,Sweden,SWE,2003,1342104,450153,97520,434864,982537,0.732087081179998
5748,Sweden,SWE,1991,1274611,425868,92954,415683,934505,0.7331687863983599
5749,Sweden,SWE,1992,1281047,427680,93260,418472,939412,0.7333157955953217
5750,Sweden,SWE,1993,1287348,429469,93528,420844,943841,0.73316694475775
5751,Sweden,SWE,1994,1293042,431319,93814,422875,948008,0.7331610264786449
5752,Sweden,SWE,1995,1298860,433230,94073,424567,951870,0.732850345687757
5753,Sweden,SWE,1990,1267468,424002,92620,412203,928825,0.7328192901122553
5754,Sweden,SWE,1997,1307800,436911,94530,425685,957126,0.7318596115614008
5755,Sweden,SWE,1998,1312294,438857,94777,425828,959462,0.7311334197976977
5756,Sweden,SWE,1999,1317025,440873,95087,426407,962367,0.7307127806989238
5757,Sweden,SWE,2000,1322606,443021,95462,427763,966246,0.7305622384897694
5758,Sweden,SWE,2001,1328597,445267,95984,429791,971042,0.7308777605248243
5759,Sweden,SWE,1996,1303703,435075,94302,425467,954844,0.7324091453344819
5760,Switzerland,CHE,2019,1434124,626925,94977,391056,1112958,0.7760542324094709
5761,Switzerland,CHE,2002,1201199,509884,78688,325385,913957,0.7608705967953686
5762,Switzerland,CHE,2001,1209174,505612,77764,342981,926357,0.7661072765375372
5763,Switzerland,CHE,2000,1209237,501499,77031,351094,929624,0.7687690667751649
5764,Switzerland,CHE,1999,1203763,497664,76460,351965,926089,0.7693283478558487
5765,Switzerland,CHE,1998,1197823,494136,75950,352154,922240,0.7699301148834177
5766,Switzerland,CHE,1994,1176052,482206,74408,351451,908065,0.772129973844694
5767,Switzerland,CHE,1996,1186498,487825,75101,351964,914890,0.7710843170405681
5768,Switzerland,CHE,1995,1181266,485004,74746,351708,911458,0.7715942048615638
5769,Switzerland,CHE,1993,1170920,479297,74071,351166,904534,0.7724985481501725
5770,Switzerland,CHE,1992,1165249,476307,73733,350600,900640,0.7729163466349253
5771,Switzerland,CHE,1991,1159150,473179,73361,349877,896417,0.7733399473752318
5772,Switzerland,CHE,1997,1192157,490859,75505,352102,918466,0.7704236941946405
5773,Switzerland,CHE,2004,1183891,519070,80765,288117,887952,0.7500285076920088
5774,Switzerland,CHE,2003,1190708,514313,79717,304771,898801,0.7548458564148389
5775,Switzerland,CHE,2006,1206674,532562,82682,292139,907383,0.7519702918932537
5776,Switzerland,CHE,2007,1235950,544658,83647,309789,938094,0.7590064322990412
5777,Switzerland,CHE,2008,1269626,558188,84620,330671,973479,0.766744694894402
5778,Switzerland,CHE,2009,1300252,570723,85603,349272,1005598,0.773387004980573
5779,Switzerland,CHE,2010,1321297,579678,86606,359610,1025894,0.7764295234152503
5780,Switzerland,CHE,2011,1334595,585690,87628,363524,1036842,0.7768963618176301
5781,Switzerland,CHE,2012,1347176,591483,88654,366561,1046698,0.7769571310652803
5782,Switzerland,CHE,2013,1359407,597118,89667,369197,1055982,0.7767960588697866
5783,Switzerland,CHE,2014,1372031,602722,90666,372068,1065456,0.7765538825288933
5784,Switzerland,CHE,2015,1384852,608252,91637,375558,1075447,0.7765790134974712
5785,Switzerland,CHE,2016,1397082,612090,92529,379998,1084617,0.776344552431425
5786,Switzerland,CHE,2017,1408994,615704,93382,384381,1093467,0.7760622117624347
5787,Switzerland,CHE,1990,1152783,469914,72947,348729,891590,0.7734239661757677
5788,Switzerland,CHE,2005,1187796,524325,81744,282924,888993,0.7484391259105099
5789,Switzerland,CHE,2018,1421469,620961,94192,387994,1103147,0.7760612436852299
5790,Syria,SYR,1991,1865616,638519,80875,405798,1125192,0.603120899477706
5791,Syria,SYR,2018,2266871,833652,112397,582364,1528413,0.6742390722718673
5792,Syria,SYR,1992,1930000,663509,84113,419941,1167563,0.6049549222797928
5793,Syria,SYR,1993,1992618,688042,87352,434166,1209560,0.6070205127124215
5794,Syria,SYR,1994,2052851,711680,90556,448333,1250569,0.6091864436337562
5795,Syria,SYR,1995,2111288,734379,93745,462927,1291051,0.6114992364850271
5796,Syria,SYR,1996,2168203,756586,96941,477513,1331040,0.6138908580054543
5797,Syria,SYR,1997,2223532,778452,100129,491885,1370466,0.6163464254168594
5798,Syria,SYR,1998,2277037,799696,103277,506381,1409354,0.6189420725267091
5799,Syria,SYR,1999,2329815,820478,106414,520876,1447768,0.6214089959932441
5800,Syria,SYR,2000,2381391,840725,109538,535779,1486042,0.6240226825414222
5801,Syria,SYR,2001,2431413,860963,112660,550391,1524014,0.626801781515522
5802,Syria,SYR,2002,2494896,885980,116410,568537,1570927,0.6296563063149726
5803,Syria,SYR,2003,2570299,915898,120823,589472,1626193,0.6326863139269011
5804,Syria,SYR,2019,2307987,847541,114910,603982,1566433,0.6787009632203301
5805,Syria,SYR,2004,2660771,951163,125996,613692,1690851,0.635474078753865
5806,Syria,SYR,2006,2917978,1050518,140559,679837,1870914,0.6411679594568568
5807,Syria,SYR,2007,2966917,1074013,143921,694240,1912174,0.6444986496083308
5808,Syria,SYR,2008,2997677,1091542,146323,704169,1942034,0.6478463156637623
5809,Syria,SYR,2009,3036316,1110890,148979,715826,1975695,0.6506882024137145
5810,Syria,SYR,2010,3033405,1113220,149226,718897,1981343,0.6531745678536166
5811,Syria,SYR,2011,2921709,1073603,143351,697884,1914838,0.6553828598262181
5812,Syria,SYR,2012,2714911,998891,132416,655430,1786737,0.6581199162698151
5813,Syria,SYR,2013,2530198,932029,122852,617922,1672803,0.6611352155048735
5814,Syria,SYR,2014,2407374,887709,116777,594257,1598743,0.6641024618526244
5815,Syria,SYR,2015,2326313,858739,113177,579781,1551697,0.6670198722183989
5816,Syria,SYR,2016,2267591,836109,110956,570441,1517506,0.6692150392200357
5817,Syria,SYR,2017,2244035,826019,110589,568935,1505543,0.670908876198455
5818,Syria,SYR,2005,2794172,1001943,133438,647962,1783343,0.6382366583016365
5819,Syria,SYR,1990,1803078,614151,77766,392381,1084298,0.6013594531129546
5820,Taiwan,TWN,2004,2397459,882260,49969,668620,1600849,0.6677273730228546
5821,Taiwan,TWN,2019,2598645,948172,56471,813045,1817688,0.699475303475465
5822,Taiwan,TWN,2018,2589767,938228,56321,809136,1803685,0.6964661299645876
5823,Taiwan,TWN,2017,2582310,933454,56127,804601,1794182,0.6947972938957755
5824,Taiwan,TWN,2016,2583264,938299,55876,800365,1794540,0.6946792894570589
5825,Taiwan,TWN,2015,2583011,943241,55556,794065,1792862,0.6940977022552363
5826,Taiwan,TWN,2014,2574206,940398,55180,784727,1780305,0.6915938351476144
5827,Taiwan,TWN,2013,2560939,936215,54804,774365,1765384,0.6893502734739094
5828,Taiwan,TWN,2012,2546090,931152,54409,763481,1749042,0.6869521501596566
5829,Taiwan,TWN,2010,2512048,919323,53432,740408,1713163,0.681978608689006
5830,Taiwan,TWN,2009,2494662,913223,52877,728125,1694225,0.6791400999413949
5831,Taiwan,TWN,2008,2477714,907878,52307,716932,1677117,0.6768807860794265
5832,Taiwan,TWN,2007,2461378,902913,51725,705845,1660483,0.6746151952280389
5833,Taiwan,TWN,2006,2441962,896506,51142,693860,1641508,0.6722086584475926
5834,Taiwan,TWN,2005,2419423,888828,50559,681755,1621142,0.6700531490359478
5835,Taiwan,TWN,2011,2529425,925449,53951,752213,1731613,0.6845876039020726
5836,Taiwan,TWN,2002,2358338,875427,48762,641049,1565238,0.663703845674369
5837,Taiwan,TWN,2003,2377350,878277,49370,655034,1582681,0.6657332744442341
5838,Taiwan,TWN,1991,2120368,811275,41164,500988,1353427,0.6382981633376847
5839,Taiwan,TWN,1992,2135010,809150,41901,512698,1363749,0.6387553219891242
5840,Taiwan,TWN,1993,2150902,809019,42625,524221,1375865,0.6396688459074379
5841,Taiwan,TWN,1994,2169624,811851,43362,536120,1391333,0.6412783966254061
5842,Taiwan,TWN,1995,2190292,817771,44077,547908,1409756,0.643638382462247
5843,Taiwan,TWN,1990,2108145,814812,40392,489455,1344659,0.6378399019042807
5844,Taiwan,TWN,1997,2236881,835482,45518,572858,1453858,0.649948745597106
5845,Taiwan,TWN,1998,2263496,846546,46232,586748,1479526,0.6536463947804635
5846,Taiwan,TWN,1999,2289944,856911,46935,600784,1504630,0.6570597359586086
5847,Taiwan,TWN,2000,2315249,865876,47580,614190,1527646,0.6598193110114722
5848,Taiwan,TWN,2001,2338327,871850,48172,627407,1547429,0.6617675799834668
5849,Taiwan,TWN,1996,2212224,825688,44798,559963,1430449,0.6466112834866632
5850,Tajikistan,TJK,2006,734597,157011,32371,158079,347461,0.4729953974764395
5851,Tajikistan,TJK,2007,748328,161064,33440,162242,356746,0.47672411028319134
5852,Tajikistan,TJK,2008,761461,165183,34516,166476,366175,0.4808847728248722
5853,Tajikistan,TJK,2009,775334,169437,35624,170926,375987,0.4849355245610279
5854,Tajikistan,TJK,2010,790466,173840,36770,176169,386779,0.48930504284814275
5855,Tajikistan,TJK,2011,806479,178222,37865,181766,397853,0.4933209668199668
5856,Tajikistan,TJK,2015,875752,197097,42193,205838,445128,0.5082808831724049
5857,Tajikistan,TJK,2013,840496,187541,40011,193605,421157,0.5010815042546306
5858,Tajikistan,TJK,2014,858148,192353,41096,199706,433155,0.504755589944858
5859,Tajikistan,TJK,2016,892718,201695,43232,211385,456312,0.5111490974753505
5860,Tajikistan,TJK,2017,910702,206341,44262,217225,467828,0.5137004201154713
5861,Tajikistan,TJK,2018,930590,211163,45299,223654,480116,0.5159264552595665
5862,Tajikistan,TJK,2012,823207,182800,38942,187660,409402,0.4973257030127295
5863,Tajikistan,TJK,2005,720277,153005,31328,153738,338071,0.4693624813786918
5864,Tajikistan,TJK,2004,704602,149001,30317,149293,328611,0.46637818229298245
5865,Tajikistan,TJK,2002,676005,141601,28492,141538,311631,0.4609891938669093
5866,Tajikistan,TJK,2001,662127,138122,27664,138135,303921,0.45900710890810975
5867,Tajikistan,TJK,2000,648206,134800,26916,135047,296763,0.4578220503975588
5868,Tajikistan,TJK,1999,632534,131685,26249,132610,290544,0.4593334113265058
5869,Tajikistan,TJK,1998,613885,128781,25663,130714,285158,0.4645137118515683
5870,Tajikistan,TJK,1997,594020,125971,25131,129026,280128,0.4715800814787381
5871,Tajikistan,TJK,1996,574634,123292,24643,127514,275449,0.4793468538234772
5872,Tajikistan,TJK,1995,557580,120801,24209,125969,270979,0.48599124789267906
5873,Tajikistan,TJK,1994,543109,118492,23795,124681,266968,0.49155510219863785
5874,Tajikistan,TJK,1993,530377,116472,23456,123676,263604,0.49701250242751854
5875,Tajikistan,TJK,1992,518114,114487,23124,122626,260237,0.5022774910540924
5876,Tajikistan,TJK,1991,505368,112325,22732,121198,256255,0.5070661379430434
5877,Tajikistan,TJK,1990,492668,110059,22311,119504,251874,0.5112448951423677
5878,Tajikistan,TJK,2019,952069,216197,46358,231009,493564,0.518412005852517
5879,Tajikistan,TJK,2003,690006,145226,29378,145265,319869,0.4635742297893062
5880,Tanzania,TZA,1990,2718527,789964,117697,851137,1758798,0.6469672730857556
5881,Tanzania,TZA,1991,2809264,815727,121536,877566,1814829,0.6460158247854242
5882,Tanzania,TZA,1993,2992940,869000,129539,932149,1930688,0.6450807567141339
5883,Tanzania,TZA,1995,3178639,923981,137884,989055,2050920,0.6452195420744539
5884,Tanzania,TZA,1996,3271468,951805,142173,1018413,2112391,0.6457012570503518
5885,Tanzania,TZA,1997,3364217,979929,146527,1048284,2174740,0.6464327360571568
5886,Tanzania,TZA,1998,3457669,1008445,150933,1077371,2236749,0.6468950613838398
5887,Tanzania,TZA,1999,3551544,1037496,155397,1106911,2299804,0.6475504738220897
5888,Tanzania,TZA,2000,3647529,1067245,159917,1137120,2364282,0.6481873070782987
5889,Tanzania,TZA,2001,3741273,1098258,164487,1166341,2429086,0.6492672413908314
5890,Tanzania,TZA,2002,3831853,1130771,169096,1193951,2493818,0.6508125442181628
5891,Tanzania,TZA,2003,3921919,1164100,173724,1221016,2558840,0.6524459072204194
5892,Tanzania,TZA,2004,4014691,1197699,178408,1248144,2624251,0.6536620128423333
5893,Tanzania,TZA,2005,4109938,1230920,183170,1277792,2691882,0.6549690043986065
5894,Tanzania,TZA,2006,4208750,1263935,188035,1308357,2760327,0.6558543510543511
5895,Tanzania,TZA,1994,3085760,896324,133673,959961,1989958,0.6448842424556673
5896,Tanzania,TZA,1992,2900169,842107,125491,904405,1872003,0.6454806599201632
5897,Tanzania,TZA,2008,4417778,1333612,198363,1372409,2904384,0.6574309528455256
5898,Tanzania,TZA,2009,4529470,1371084,203878,1407835,2982797,0.6585311305737758
5899,Tanzania,TZA,2010,4645967,1410712,209624,1445999,3066335,0.6599993069257702
5900,Tanzania,TZA,2011,4770974,1454262,215593,1487873,3157728,0.6618623367052514
5901,Tanzania,TZA,2012,4901504,1502672,221850,1532143,3256665,0.6644215734599013
5902,Tanzania,TZA,2013,5036098,1554838,228463,1577620,3360921,0.6673660838212442
5903,Tanzania,TZA,2014,5179771,1609154,235432,1626667,3471253,0.670155688349929
5904,Tanzania,TZA,2015,5325415,1663643,242722,1677768,3584133,0.6730241680695307
5905,Tanzania,TZA,2016,5476522,1720187,250271,1732532,3702990,0.6761572399417002
5906,Tanzania,TZA,2017,5633429,1776673,258107,1789578,3824358,0.6788685896280933
5907,Tanzania,TZA,2018,5797310,1827415,266247,1853047,3946709,0.680782811338362
5908,Tanzania,TZA,2019,5965121,1873190,274696,1922665,4070551,0.6823920252413991
5909,Tanzania,TZA,2007,4311570,1297984,193083,1339988,2831055,0.656618122864757
5910,Thailand,THA,2018,8684176,2668039,275233,2496652,5439924,0.6264179813951261
5911,Thailand,THA,2019,8707630,2694793,277009,2514313,5486115,0.6300353827620144
5912,Thailand,THA,1992,7252820,1921084,192672,1609541,3723297,0.5133585281311269
5913,Thailand,THA,2017,8658256,2645567,273281,2472927,5391775,0.6227322222858738
5914,Thailand,THA,2016,8628521,2625305,271139,2447533,5343977,0.6193387024265224
5915,Thailand,THA,2015,8591261,2603285,268750,2419561,5291596,0.6159277433196361
5916,Thailand,THA,2014,8556321,2579954,266172,2387780,5233906,0.6117005194171654
5917,Thailand,THA,2013,8534568,2554855,263534,2358748,5177137,0.6066079735963202
5918,Thailand,THA,2012,8507210,2526994,260657,2327340,5114991,0.6012536424985395
5919,Thailand,THA,2011,8472640,2496824,257507,2294848,5049179,0.5959392822071987
5920,Thailand,THA,2010,8427285,2467139,254294,2260843,4982276,0.5912077258571414
5921,Thailand,THA,2009,8473017,2460068,253635,2248045,4961748,0.5855940097842363
5922,Thailand,THA,2008,8602896,2474119,255532,2254569,4984220,0.5793653671972787
5923,Thailand,THA,2007,8529934,2432567,251467,2217705,4901739,0.5746514568576967
5924,Thailand,THA,2006,8261244,2341601,241918,2139359,4722878,0.5716908978841443
5925,Thailand,THA,1990,7088775,1841362,183604,1525578,3550544,0.5008684857397787
5926,Thailand,THA,1991,7172628,1882395,188268,1568210,3638873,0.507327718654864
5927,Thailand,THA,2004,8031668,2254262,232182,2046437,4532881,0.564376042436017
5928,Thailand,THA,2003,7961246,2227588,228890,2008037,4464515,0.5607809380591933
5929,Thailand,THA,2002,7891686,2202093,225668,1969996,4397757,0.5572645693201681
5930,Thailand,THA,2001,7822253,2177096,222514,1932874,4332484,0.5538665139059041
5931,Thailand,THA,2000,7758358,2152046,219450,1897513,4269009,0.5502464567889236
5932,Thailand,THA,1999,7700359,2127061,216519,1864103,4207683,0.5464268613969816
5933,Thailand,THA,1998,7642071,2101575,213593,1828824,4143992,0.5422603375446263
5934,Thailand,THA,1997,7580497,2075123,210569,1793742,4079434,0.5381486200706893
5935,Thailand,THA,1996,7520200,2047693,207411,1758093,4013197,0.5336556208611473
5936,Thailand,THA,1995,7453797,2019086,204051,1722124,3945261,0.5292954718246284
5937,Thailand,THA,1994,7388343,1988930,200495,1685824,3875249,0.524508540006873
5938,Thailand,THA,1993,7324536,1956543,196736,1648774,3802053,0.5190844853517
5939,Thailand,THA,2005,8096963,2282423,235513,2082202,4600138,0.5681312857672686
5940,Timor,TLS,1991,85134,24597,2022,18798,45417,0.5334766368313483
5941,Timor,TLS,1992,86497,25127,2060,19122,46309,0.5353827300368799
5942,Timor,TLS,2018,132991,45093,3543,30138,78774,0.5923257964824687
5943,Timor,TLS,1993,87730,25617,2094,19408,47119,0.5370910748888635
5944,Timor,TLS,1994,88794,26068,2125,19646,47839,0.5387638804423722
5945,Timor,TLS,1995,89785,26489,2155,19904,48548,0.540713927716211
5946,Timor,TLS,1996,90674,26892,2184,20072,49148,0.5420296887751725
5947,Timor,TLS,1997,91507,27291,2212,20169,49672,0.5428218606226846
5948,Timor,TLS,1998,92212,27683,2240,20213,50136,0.5437036394395524
5949,Timor,TLS,1999,92867,28049,2264,20227,50540,0.5442191521207749
5950,Timor,TLS,2000,93639,28428,2291,20343,51062,0.5453069767938573
5951,Timor,TLS,2001,94694,28862,2324,20533,51719,0.5461697678839208
5952,Timor,TLS,2002,95972,29329,2360,20763,52452,0.5465344058683783
5953,Timor,TLS,2003,97373,29847,2400,21023,53270,0.5470715701477823
5954,Timor,TLS,2004,98993,30437,2445,21326,54208,0.5475942743426303
5955,Timor,TLS,2005,100803,31125,2499,21710,55334,0.5489320754342629
5956,Timor,TLS,2006,102461,31927,2559,22115,56601,0.5524150652443369
5957,Timor,TLS,2007,103818,32851,2624,22555,58030,0.5589589473886994
5958,Timor,TLS,2008,105203,33864,2696,23030,59590,0.5664287140100568
5959,Timor,TLS,2009,106823,34930,2772,23550,61252,0.5733971148535427
5960,Timor,TLS,2010,109114,36007,2850,24171,63028,0.5776344007185146
5961,Timor,TLS,2011,111831,37080,2930,24850,64860,0.5799822947125574
5962,Timor,TLS,2012,114642,38189,3011,25590,66790,0.5825962561713857
5963,Timor,TLS,2013,117529,39321,3095,26345,68761,0.5850556032979094
5964,Timor,TLS,2014,120521,40461,3182,27123,70766,0.5871673816181412
5965,Timor,TLS,2015,123392,41582,3268,27853,72703,0.5892035140041494
5966,Timor,TLS,2016,126504,42761,3358,28595,74714,0.5906058306456713
5967,Timor,TLS,2017,129700,43938,3450,29347,76735,0.5916345412490362
5968,Timor,TLS,2019,136426,46290,3638,30955,80883,0.5928708603931802
5969,Timor,TLS,1990,83550,24020,1981,18416,44417,0.5316217833632555
5970,Togo,TGO,2005,587315,177574,24454,178239,380267,0.6474668619054511
5971,Togo,TGO,2018,844056,259647,36040,267444,563131,0.6671725572710815
5972,Togo,TGO,2016,800384,245382,33981,250966,530329,0.6625932052614745
5973,Togo,TGO,2015,779507,238355,33000,243069,514424,0.6599350615196528
5974,Togo,TGO,2014,759208,231565,32048,235506,499119,0.6574206278121411
5975,Togo,TGO,2013,739158,224846,31120,228357,484323,0.6552360929598272
5976,Togo,TGO,2012,719597,218264,30212,221515,469991,0.6531308496283337
5977,Togo,TGO,2011,699975,211894,29327,214607,455828,0.6512061145040894
5978,Togo,TGO,2010,680659,205796,28463,208206,442465,0.6500538448768032
5979,Togo,TGO,2009,661079,199869,27624,201749,429242,0.649305151124147
5980,Togo,TGO,2008,642205,194013,26806,195688,416507,0.6485577035370326
5981,Togo,TGO,2007,623303,188296,26006,189775,404077,0.6482834191396479
5982,Togo,TGO,2006,604934,182789,25222,183954,391965,0.6479467181543772
5983,Togo,TGO,2004,570189,172612,23708,172620,368940,0.6470486101976713
5984,Togo,TGO,2017,822051,252504,34993,259170,546667,0.6650037528085241
5985,Togo,TGO,2003,553167,167777,22978,167112,357867,0.6469420627043913
5986,Togo,TGO,2001,520094,158384,21565,156227,336176,0.6463754628970917
5987,Togo,TGO,2000,504343,153795,20877,150915,325587,0.645566608439098
5988,Togo,TGO,1999,489122,149284,20203,145667,315154,0.644325955487588
5989,Togo,TGO,1998,474060,144848,19542,140413,304803,0.6429629160865713
5990,Togo,TGO,1997,459350,140466,18892,135272,294630,0.6414063350386415
5991,Togo,TGO,1996,444837,136134,18253,130322,284709,0.6400299435523574
5992,Togo,TGO,1995,430655,131842,17622,125605,275069,0.6387224112108301
5993,Togo,TGO,1994,416683,127617,17004,121031,265652,0.6375398084395092
5994,Togo,TGO,1993,402825,123474,16401,116563,256438,0.6365990194253087
5995,Togo,TGO,1992,389353,119401,15812,112295,247508,0.6356904916618081
5996,Togo,TGO,1991,376064,115416,15239,108223,238878,0.6352057096664397
5997,Togo,TGO,1990,363171,111520,14680,104256,230456,0.6345660859484926
5998,Togo,TGO,2002,536374,163039,22265,161665,346969,0.646878856917002
5999,Togo,TGO,2019,866570,266922,37115,276012,580049,0.6693619672963523
6000,Tokelau,TKL,2018,151,53,4,41,98,0.6490066225165563
6001,Tokelau,TKL,1990,176,59,4,43,106,0.6022727272727273
6002,Tokelau,TKL,2017,149,52,4,40,96,0.6442953020134228
6003,Tokelau,TKL,2016,146,51,3,39,93,0.636986301369863
6004,Tokelau,TKL,2015,144,51,3,38,92,0.6388888888888888
6005,Tokelau,TKL,2014,142,50,3,38,91,0.6408450704225352
6006,Tokelau,TKL,2013,141,50,3,37,90,0.6382978723404256
6007,Tokelau,TKL,2012,140,49,3,37,89,0.6357142857142857
6008,Tokelau,TKL,2011,139,49,3,36,88,0.6330935251798561
6009,Tokelau,TKL,2010,137,48,3,36,87,0.635036496350365
6010,Tokelau,TKL,2009,134,47,3,35,85,0.6343283582089553
6011,Tokelau,TKL,2008,132,46,3,34,83,0.6287878787878788
6012,Tokelau,TKL,2007,131,45,3,34,82,0.6259541984732825
6013,Tokelau,TKL,2006,133,45,3,34,82,0.6165413533834586
6014,Tokelau,TKL,2019,154,54,4,41,99,0.6428571428571429
6015,Tokelau,TKL,2004,145,49,3,37,89,0.6137931034482759
6016,Tokelau,TKL,2002,163,56,4,41,101,0.6196319018404908
6017,Tokelau,TKL,2001,169,58,4,42,104,0.6153846153846154
6018,Tokelau,TKL,2000,171,59,4,42,105,0.6140350877192983
6019,Tokelau,TKL,1999,170,58,4,41,103,0.6058823529411764
6020,Tokelau,TKL,1998,168,57,4,41,102,0.6071428571428571
6021,Tokelau,TKL,1997,166,56,4,41,101,0.608433734939759
6022,Tokelau,TKL,1996,165,56,4,40,100,0.6060606060606061
6023,Tokelau,TKL,1995,166,56,4,41,101,0.608433734939759
6024,Tokelau,TKL,1994,167,57,4,41,102,0.6107784431137725
6025,Tokelau,TKL,1993,169,57,4,41,102,0.6035502958579881
6026,Tokelau,TKL,1992,171,58,4,42,104,0.6081871345029239
6027,Tokelau,TKL,1991,173,58,4,42,104,0.6011560693641619
6028,Tokelau,TKL,2003,154,53,3,39,95,0.6168831168831169
6029,Tokelau,TKL,2005,137,47,3,35,85,0.6204379562043796
6030,Tonga,TON,1997,10334,3670,237,2190,6097,0.5899941939229727
6031,Tonga,TON,2005,10811,3842,253,2342,6437,0.5954120802885949
6032,Tonga,TON,2018,10889,3975,261,2433,6669,0.6124529341537331
6033,Tonga,TON,2017,10903,3974,260,2420,6654,0.6102907456663303
6034,Tonga,TON,2016,10946,3988,260,2416,6664,0.6088068700895304
6035,Tonga,TON,2015,10993,4003,260,2416,6679,0.6075684526516875
6036,Tonga,TON,2014,11028,4007,261,2413,6681,0.6058215451577802
6037,Tonga,TON,2013,11057,4006,261,2410,6677,0.6038708510445872
6038,Tonga,TON,2012,11073,3999,261,2406,6666,0.6020048767271742
6039,Tonga,TON,2011,11074,3988,260,2398,6646,0.6001444825717898
6040,Tonga,TON,2010,11057,3973,260,2390,6623,0.5989870670163697
6041,Tonga,TON,2009,11030,3954,259,2383,6596,0.5980054397098822
6042,Tonga,TON,2008,10987,3929,258,2376,6563,0.5973423136433967
6043,Tonga,TON,2007,10932,3898,257,2367,6522,0.5965971459934138
6044,Tonga,TON,2006,10872,3868,255,2357,6480,0.5960264900662252
6045,Tonga,TON,1990,10052,3527,224,2079,5830,0.5799840827695981
6046,Tonga,TON,2004,10753,3821,252,2324,6397,0.594903747791314
6047,Tonga,TON,2003,10695,3803,250,2305,6358,0.5944834034595605
6048,Tonga,TON,2002,10636,3786,248,2285,6319,0.5941143286949981
6049,Tonga,TON,2001,10581,3768,245,2265,6278,0.5933276627917966
6050,Tonga,TON,2000,10520,3748,243,2246,6237,0.5928707224334601
6051,Tonga,TON,1999,10460,3724,241,2227,6192,0.5919694072657744
6052,Tonga,TON,1998,10397,3698,239,2207,6144,0.5909396941425411
6053,Tonga,TON,1996,10276,3644,235,2172,6051,0.5888478007006618
6054,Tonga,TON,1995,10224,3620,233,2154,6007,0.587539123630673
6055,Tonga,TON,1994,10176,3599,231,2136,5966,0.5862814465408805
6056,Tonga,TON,1993,10137,3579,229,2121,5929,0.5848870474499359
6057,Tonga,TON,1992,10103,3561,227,2107,5895,0.5834900524596655
6058,Tonga,TON,1991,10076,3543,225,2093,5861,0.5816792377927749
6059,Tonga,TON,2019,10891,3985,261,2456,6702,0.6153704893949132
6060,Trinidad and Tobago,TTO,2019,201112,58143,13870,60445,132458,0.6586280281634115
6061,Trinidad and Tobago,TTO,2018,200050,57806,13853,59650,131309,0.6563809047738065
6062,Trinidad and Tobago,TTO,1991,167930,44183,10623,44932,99738,0.5939260406121598
6063,Trinidad and Tobago,TTO,2017,199214,57509,13835,59098,130442,0.6547832983625649
6064,Trinidad and Tobago,TTO,2016,198622,57276,13817,58804,129897,0.653990997976055
6065,Trinidad and Tobago,TTO,2015,197956,57007,13797,58482,129286,0.6531047303441169
6066,Trinidad and Tobago,TTO,2014,197091,56598,13775,58021,128394,0.6514452714735832
6067,Trinidad and Tobago,TTO,2013,196048,56070,13749,57492,127311,0.6493868848445279
6068,Trinidad and Tobago,TTO,2012,194996,55499,13717,56916,126132,0.646844037826417
6069,Trinidad and Tobago,TTO,2011,194003,54970,13679,56378,125027,0.6444591063024798
6070,Trinidad and Tobago,TTO,2010,193271,54565,13637,55934,124136,0.642289841724832
6071,Trinidad and Tobago,TTO,2009,192812,54247,13589,55611,123447,0.640245420409518
6072,Trinidad and Tobago,TTO,2008,192479,53929,13532,55396,122857,0.6382878132159872
6073,Trinidad and Tobago,TTO,2007,192190,53605,13461,55191,122257,0.6361257089338676
6074,Trinidad and Tobago,TTO,2006,191803,53269,13371,54910,121550,0.6337231430165325
6075,Trinidad and Tobago,TTO,1990,165740,43605,10471,44415,98491,0.5942500301677326
6076,Trinidad and Tobago,TTO,2005,191353,52933,13265,54502,120700,0.6307714015458341
6077,Trinidad and Tobago,TTO,2003,190240,52237,13002,53529,118768,0.6243061396131203
6078,Trinidad and Tobago,TTO,2002,189530,51824,12840,52992,117656,0.6207777132907719
6079,Trinidad and Tobago,TTO,2001,188504,51343,12659,52323,116325,0.6170956584475661
6080,Trinidad and Tobago,TTO,2000,187207,50782,12462,51598,114842,0.6134492834135475
6081,Trinidad and Tobago,TTO,1999,185655,50126,12253,50825,113204,0.6097546524467427
6082,Trinidad and Tobago,TTO,1998,183935,49386,12035,50084,111505,0.606219588441569
6083,Trinidad and Tobago,TTO,1997,181930,48585,11811,49298,109694,0.602946188094322
6084,Trinidad and Tobago,TTO,1996,179716,47769,11588,48497,107854,0.6001357697700817
6085,Trinidad and Tobago,TTO,1995,177391,46977,11372,47678,106027,0.5977022509597443
6086,Trinidad and Tobago,TTO,1994,174987,46223,11166,46891,104280,0.5959299833701932
6087,Trinidad and Tobago,TTO,1993,172627,45506,10973,46197,102676,0.5947852885122258
6088,Trinidad and Tobago,TTO,1992,170246,44822,10791,45531,101144,0.594105000998555
6089,Trinidad and Tobago,TTO,2004,190845,52597,13143,54049,119789,0.6276769105818858
6090,Tunisia,TUN,1991,1287419,413563,61857,373929,849349,0.6597300490360947
6091,Tunisia,TUN,1990,1255996,402089,60050,363205,825344,0.6571231118570441
6092,Tunisia,TUN,2019,1828614,616414,98242,634834,1349490,0.7379851625329348
6093,Tunisia,TUN,2018,1806075,608030,97508,621197,1326735,0.7345957393795939
6094,Tunisia,TUN,2017,1787785,601962,96780,611002,1309744,0.7326071087966394
6095,Tunisia,TUN,2016,1775412,598483,96051,604936,1299470,0.7319258853719587
6096,Tunisia,TUN,2015,1763037,594914,95318,599324,1289556,0.7314401229242494
6097,Tunisia,TUN,2014,1747908,589445,94570,591954,1275969,0.7299978030880344
6098,Tunisia,TUN,2013,1732216,582951,93799,583925,1260675,0.7277816392412956
6099,Tunisia,TUN,2012,1716370,576142,92995,575705,1244842,0.7252760185740836
6100,Tunisia,TUN,2010,1687008,564374,91236,559991,1215601,0.720566233236594
6101,Tunisia,TUN,2009,1674009,559722,90245,552401,1202368,0.7182565924078066
6102,Tunisia,TUN,2008,1661227,554921,89159,544334,1188414,0.715383267909804
6103,Tunisia,TUN,2007,1647729,549934,87977,535836,1173747,0.7123422601653548
6104,Tunisia,TUN,2006,1633742,544728,86706,527052,1158486,0.7090997232121106
6105,Tunisia,TUN,2005,1618812,539291,85354,518056,1142701,0.7058886393231579
6106,Tunisia,TUN,2011,1701033,569720,92144,567622,1229486,0.7227878589069112
6107,Tunisia,TUN,2003,1584978,526711,82420,499457,1108588,0.6994343139147673
6108,Tunisia,TUN,2004,1602463,533360,83923,508835,1126118,0.702741966585188
6109,Tunisia,TUN,1992,1318724,424959,63669,384689,873317,0.6622439570372572
6110,Tunisia,TUN,1993,1348942,436156,65477,395346,896979,0.6649500126766014
6111,Tunisia,TUN,1994,1377867,447010,67271,405980,920261,0.6678881198257887
6112,Tunisia,TUN,1996,1431759,467277,70773,427214,965264,0.6741805010480115
6113,Tunisia,TUN,1997,1456759,476989,72500,438125,987614,0.6779529077905131
6114,Tunisia,TUN,1995,1405834,457340,69033,416697,943070,0.6708260007938348
6115,Tunisia,TUN,1999,1503578,495368,75916,459315,1030599,0.685431018543767
6116,Tunisia,TUN,2000,1525226,503798,77596,469753,1051147,0.6891745878971378
6117,Tunisia,TUN,2001,1546334,511795,79244,480157,1071196,0.6927326179208373
6118,Tunisia,TUN,2002,1565964,519478,80855,489696,1090029,0.6960753887062537
6119,Tunisia,TUN,1998,1480664,486392,74215,448624,1009231,0.6816070357623336
6120,Turkey,TUR,2005,10536295,3334960,593054,3109719,7037733,0.6679514003736607
6121,Turkey,TUR,2009,10800502,3436791,624973,3191291,7253055,0.6715479521229661
6122,Turkey,TUR,2006,10627898,3366778,601104,3146850,7114732,0.66943924377144
6123,Turkey,TUR,2007,10697180,3391853,609199,3167717,7168769,0.6701550315129782
6124,Turkey,TUR,2008,10750677,3413975,617216,3178980,7210171,0.6706713446976409
6125,Turkey,TUR,2010,10869466,3469207,633278,3217015,7319500,0.6734001467965399
6126,Turkey,TUR,2016,11706511,3841228,707914,3521885,8071027,0.6894476928266672
6127,Turkey,TUR,2012,11131208,3587657,655255,3319002,7561914,0.6793435177924984
6128,Turkey,TUR,2013,11320493,3669813,669831,3387271,7726915,0.6825599379814996
6129,Turkey,TUR,2014,11500964,3748545,684471,3454682,7887698,0.6858292922228084
6130,Turkey,TUR,2015,11640724,3807642,697002,3512825,8017469,0.6887431572125583
6131,Turkey,TUR,2004,10412794,3289247,584849,3047270,6921366,0.6646982548583983
6132,Turkey,TUR,2011,10980892,3519592,643138,3261609,7424339,0.6761143812360598
6133,Turkey,TUR,2003,10249598,3230494,576309,2962149,6768952,0.6604114619909971
6134,Turkey,TUR,2019,11810598,3921790,728960,3593252,8244002,0.6980173230855881
6135,Turkey,TUR,2001,9904146,3103250,558415,2782184,6443849,0.6506213660420596
6136,Turkey,TUR,2000,9760645,3049302,549536,2713688,6312526,0.6467324649139478
6137,Turkey,TUR,1999,9606119,2978944,540193,2654268,6173405,0.6426533962362948
6138,Turkey,TUR,1998,9417708,2880905,530369,2594096,6005370,0.6376678911684244
6139,Turkey,TUR,1997,9216775,2775299,520146,2534871,5830316,0.6325765791179669
6140,Turkey,TUR,1996,9028098,2681402,509667,2476064,5667133,0.6277216973054568
6141,Turkey,TUR,1995,8870224,2616783,498996,2421282,5537061,0.6242301209078823
6142,Turkey,TUR,1994,8732208,2573916,488124,2366976,5429016,0.6217231655498815
6143,Turkey,TUR,1993,8592105,2533943,477035,2313178,5324156,0.6196567662988289
6144,Turkey,TUR,1992,8451229,2495476,465698,2260952,5222126,0.6179132052864738
6145,Turkey,TUR,1991,8306967,2457360,454111,2207761,5119232,0.6162576545687494
6146,Turkey,TUR,1990,8154361,2418386,442257,2154916,5015559,0.6150768895318713
6147,Turkey,TUR,2017,11735291,3861282,716686,3517286,8095254,0.6898213261179463
6148,Turkey,TUR,2002,10074350,3165525,567343,2869383,6602251,0.6553525537627738
6149,Turkey,TUR,2018,11770196,3887091,723215,3546719,8157025,0.6930237185515008
6150,Turkmenistan,TKM,1992,361449,78258,16544,96758,191560,0.5299779498629129
6151,Turkmenistan,TKM,1990,344721,75070,15835,92797,183702,0.5329005195505931
6152,Turkmenistan,TKM,2018,488776,115618,25518,146316,287452,0.5881057989753998
6153,Turkmenistan,TKM,2017,483631,114182,25245,144359,283786,0.5867820714553037
6154,Turkmenistan,TKM,2016,478680,112655,24972,142384,280011,0.5849649034845826
6155,Turkmenistan,TKM,2015,474040,111109,24699,140393,276201,0.5826533625854359
6156,Turkmenistan,TKM,2014,469630,109563,24418,138341,272322,0.5798650001064668
6157,Turkmenistan,TKM,2013,465618,107892,24125,136202,268219,0.5760494654416282
6158,Turkmenistan,TKM,2012,461843,106221,23819,134003,264043,0.571715929439225
6159,Turkmenistan,TKM,2011,458286,104674,23498,131861,260033,0.5674033245615183
6160,Turkmenistan,TKM,2010,455146,103363,23163,129704,256230,0.5629622143224372
6161,Turkmenistan,TKM,2009,452776,102241,22813,127975,253029,0.5588392494301818
6162,Turkmenistan,TKM,2008,451235,101185,22459,126746,250390,0.5548993318337452
6163,Turkmenistan,TKM,2007,450104,100163,22103,125678,247944,0.5508593569486163
6164,Turkmenistan,TKM,2019,494098,117061,25794,148082,290937,0.5888244842116341
6165,Turkmenistan,TKM,2006,448472,99121,21742,124451,245314,0.5469995897179757
6166,Turkmenistan,TKM,2004,442884,96781,20996,120599,238376,0.5382357457031638
6167,Turkmenistan,TKM,2003,439439,95384,20606,118361,234351,0.5332958613140846
6168,Turkmenistan,TKM,2002,435278,93879,20211,115985,230075,0.5285702470604993
6169,Turkmenistan,TKM,2001,430378,92320,19812,113647,225779,0.5246062763431216
6170,Turkmenistan,TKM,2000,424465,90762,19416,111355,221533,0.521911111634646
6171,Turkmenistan,TKM,1999,417662,89210,19029,109294,217533,0.520835029282051
6172,Turkmenistan,TKM,1998,410190,87636,18654,107475,213765,0.5211365464784612
6173,Turkmenistan,TKM,1997,402303,86058,18290,105747,210095,0.5222307564199123
6174,Turkmenistan,TKM,1996,394084,84488,17935,104030,206453,0.5238806954862415
6175,Turkmenistan,TKM,1995,385805,82929,17583,102209,202721,0.5254493850520341
6176,Turkmenistan,TKM,1994,377809,81379,17236,100415,199030,0.5268005791286073
6177,Turkmenistan,TKM,1993,369659,79831,16892,98643,195366,0.5285032962811672
6178,Turkmenistan,TKM,2005,446237,98019,21374,122781,242174,0.5427026445588331
6179,Turkmenistan,TKM,1991,353083,76665,16190,94781,187636,0.5314217903439135
6180,Tuvalu,TUV,2019,1384,477,31,362,870,0.6286127167630058
6181,Tuvalu,TUV,1992,1064,352,23,268,643,0.6043233082706767
6182,Tuvalu,TUV,2018,1368,470,31,356,857,0.6264619883040936
6183,Tuvalu,TUV,2017,1352,463,30,350,843,0.6235207100591716
6184,Tuvalu,TUV,2016,1338,459,30,345,834,0.6233183856502242
6185,Tuvalu,TUV,2015,1324,454,30,340,824,0.622356495468278
6186,Tuvalu,TUV,2014,1307,447,29,335,811,0.6205049732211171
6187,Tuvalu,TUV,2013,1288,440,29,330,799,0.6203416149068323
6188,Tuvalu,TUV,2012,1270,432,28,325,785,0.6181102362204725
6189,Tuvalu,TUV,2011,1251,425,28,320,773,0.6179056754596323
6190,Tuvalu,TUV,2010,1233,418,27,316,761,0.6171938361719383
6191,Tuvalu,TUV,2009,1215,411,27,311,749,0.6164609053497943
6192,Tuvalu,TUV,2008,1197,404,26,306,736,0.6148705096073517
6193,Tuvalu,TUV,2007,1179,397,26,302,725,0.6149279050042409
6194,Tuvalu,TUV,1991,1064,351,23,267,641,0.6024436090225563
6195,Tuvalu,TUV,2006,1162,391,26,298,715,0.6153184165232358
6196,Tuvalu,TUV,2004,1133,381,25,290,696,0.6142983230361871
6197,Tuvalu,TUV,2003,1122,377,25,287,689,0.6140819964349377
6198,Tuvalu,TUV,2002,1112,374,24,284,682,0.6133093525179856
6199,Tuvalu,TUV,2001,1103,371,24,281,676,0.6128739800543971
6200,Tuvalu,TUV,2000,1096,368,24,279,671,0.6122262773722628
6201,Tuvalu,TUV,1999,1090,366,24,277,667,0.6119266055045871
6202,Tuvalu,TUV,1998,1084,363,24,275,662,0.6107011070110702
6203,Tuvalu,TUV,1997,1079,361,23,274,658,0.6098239110287303
6204,Tuvalu,TUV,1996,1074,359,23,273,655,0.6098696461824954
6205,Tuvalu,TUV,1995,1071,357,23,271,651,0.6078431372549019
6206,Tuvalu,TUV,1994,1067,355,23,270,648,0.6073102155576382
6207,Tuvalu,TUV,1993,1065,353,23,269,645,0.6056338028169014
6208,Tuvalu,TUV,2005,1147,385,25,294,704,0.6137750653879687
6209,Tuvalu,TUV,1990,1065,350,23,266,639,0.6
6210,Uganda,UGA,2019,4785579,1405452,186867,1795181,3387500,0.7078558310290145
6211,Uganda,UGA,2018,4649015,1370150,180709,1735319,3286178,0.7068546778188498
6212,Uganda,UGA,2016,4377587,1285883,169101,1619624,3074608,0.7023522319487883
6213,Uganda,UGA,2015,4246699,1241027,163659,1564882,2969568,0.6992650055961113
6214,Uganda,UGA,2014,4132783,1197980,158428,1527447,2883855,0.6977997635007693
6215,Uganda,UGA,2013,4037785,1154743,153473,1508283,2816499,0.6975356538300083
6216,Uganda,UGA,2012,3952741,1112788,148757,1498116,2759661,0.69816388172157
6217,Uganda,UGA,2011,3873242,1073403,144250,1490430,2708083,0.6991773299990034
6218,Uganda,UGA,2010,3793403,1037656,139920,1476945,2654521,0.6997730006540301
6219,Uganda,UGA,2009,3717865,1004254,135717,1464766,2604737,0.7006002100667991
6220,Uganda,UGA,2008,3650958,971704,131662,1459216,2562582,0.7018930373890907
6221,Uganda,UGA,2007,3582921,940208,127720,1452207,2520135,0.7033744255036602
6222,Uganda,UGA,2006,3510368,909913,123860,1437682,2471455,0.7040444192745604
6223,Uganda,UGA,2005,3425270,881103,120094,1408785,2409982,0.7035889141585919
6224,Uganda,UGA,2017,4512643,1330538,174782,1677164,3182484,0.7052372633953096
6225,Uganda,UGA,2004,3332896,853107,116416,1372119,2341642,0.702584779123021
6226,Uganda,UGA,2002,3146973,797690,109249,1297837,2204776,0.7006021341778274
6227,Uganda,UGA,2001,3052684,770417,105708,1259718,2135843,0.6996606920336333
6228,Uganda,UGA,2000,2958116,744095,102248,1220380,2066723,0.6986619185995411
6229,Uganda,UGA,1999,2860781,718730,98893,1176570,1994193,0.6970799232796918
6230,Uganda,UGA,1998,2759138,694327,95656,1126280,1916263,0.6945150985561432
6231,Uganda,UGA,1997,2658477,670894,92553,1074070,1837517,0.6911916108358281
6232,Uganda,UGA,1996,2559419,648506,89598,1023137,1761241,0.6881409413620826
6233,Uganda,UGA,1995,2465532,627194,86794,976718,1690706,0.6857367902748778
6234,Uganda,UGA,1994,2376221,606940,84148,933300,1624388,0.6836013990281207
6235,Uganda,UGA,1993,2288915,588006,81652,888405,1558063,0.6806993706625192
6236,Uganda,UGA,1992,2204517,570311,79303,843717,1493331,0.6773960010287968
6237,Uganda,UGA,1991,2123248,553849,77102,799264,1430215,0.6735977144450389
6238,Uganda,UGA,2003,3240300,825306,112815,1335650,2273771,0.7017161991173657
6239,Uganda,UGA,1990,2045946,538571,75041,756269,1369881,0.6695587273564405
6240,Ukraine,UKR,2019,5629417,1536612,267337,2211421,4015370,0.7132834536862342
6241,Ukraine,UKR,2018,5662736,1546074,269708,2224310,4040092,0.7134522958513341
6242,Ukraine,UKR,1991,6637427,1747288,300619,2640011,4687918,0.7062854325930816
6243,Ukraine,UKR,2017,5694252,1555605,271993,2236189,4063787,0.7136647622901129
6244,Ukraine,UKR,2016,5723597,1565887,274363,2244673,4084923,0.7136985710209856
6245,Ukraine,UKR,2015,5754513,1576844,276819,2254467,4108130,0.713897075217312
6246,Ukraine,UKR,2014,5792709,1586382,278878,2272529,4137789,0.7143098332748978
6247,Ukraine,UKR,2013,5836432,1594607,280632,2297742,4172981,0.7149883696066364
6248,Ukraine,UKR,2012,5886520,1602822,282189,2328527,4213538,0.7157943912532362
6249,Ukraine,UKR,2011,5937490,1610447,283704,2358760,4252911,0.7162809537363432
6250,Ukraine,UKR,2010,5985894,1617289,285136,2383623,4286048,0.7160247074204789
6251,Ukraine,UKR,2009,6031248,1610205,286480,2411539,4308224,0.7143171695145019
6252,Ukraine,UKR,2008,6079224,1584814,287972,2450122,4322908,0.7110953634871819
6253,Ukraine,UKR,2007,6133505,1553999,289451,2494401,4337851,0.7072385202262002
6254,Ukraine,UKR,2006,6193825,1529369,290911,2539283,4359563,0.7038563407910298
6255,Ukraine,UKR,1990,6582090,1743942,300652,2591796,4636390,0.7043948046896958
6256,Ukraine,UKR,2005,6264259,1524407,292280,2578017,4394704,0.7015520909975146
6257,Ukraine,UKR,2003,6423740,1542743,294432,2654855,4492030,0.6992857743308415
6258,Ukraine,UKR,2002,6495954,1550825,295027,2689971,4535823,0.6982535590615327
6259,Ukraine,UKR,2001,6555280,1557881,295552,2716817,4570250,0.6971860851100182
6260,Ukraine,UKR,2000,6596364,1563971,295848,2730773,4590592,0.6959276352851359
6261,Ukraine,UKR,1999,6629860,1584268,296065,2735796,4616129,0.6962634203437177
6262,Ukraine,UKR,1998,6661192,1623353,296148,2734925,4654426,0.6987377034020338
6263,Ukraine,UKR,1997,6691698,1669577,296401,2733965,4699943,0.702354320233818
6264,Ukraine,UKR,1996,6717079,1710503,297136,2733635,4741274,0.7058535413979797
6265,Ukraine,UKR,1995,6732911,1732409,298080,2735288,4765777,0.707833060618208
6266,Ukraine,UKR,1994,6733182,1739498,299023,2730390,4768911,0.7082700274550725
6267,Ukraine,UKR,1993,6715401,1744648,299728,2711202,4755578,0.7081599445811203
6268,Ukraine,UKR,1992,6681975,1747405,300285,2680668,4728358,0.70762880735112
6269,Ukraine,UKR,2004,6343922,1534093,293508,2615540,4443141,0.7003776212885341
6270,United Arab Emirates,ARE,1991,235918,81563,15287,73439,170289,0.7218143592265109
6271,United Arab Emirates,ARE,1990,220828,76374,14276,68548,159198,0.7209140145271433
6272,United Arab Emirates,ARE,1992,252134,87142,16394,78743,182279,0.7229449419752988
6273,United Arab Emirates,ARE,2018,1249373,411874,87466,408367,907707,0.7265300274617749
6274,United Arab Emirates,ARE,2017,1237869,408421,86918,401456,896795,0.7244668054535658
6275,United Arab Emirates,ARE,2016,1228228,408143,86345,395425,889913,0.724550327789303
6276,United Arab Emirates,ARE,2015,1217828,407735,85719,389512,882966,0.7250334201545703
6277,United Arab Emirates,ARE,2014,1201773,404257,84996,381940,871193,0.724923092797059
6278,United Arab Emirates,ARE,2013,1182668,399603,84127,373722,857452,0.7250149661612557
6279,United Arab Emirates,ARE,2012,1160861,394214,83066,364571,841851,0.7251953506922879
6280,United Arab Emirates,ARE,2011,1137200,388396,81763,355325,825484,0.7258916637354906
6281,United Arab Emirates,ARE,2010,1111417,382290,80158,345525,807973,0.7269755636273334
6282,United Arab Emirates,ARE,2009,1080128,374072,77904,334796,786772,0.7284062629614267
6283,United Arab Emirates,ARE,2008,930374,323537,66581,289019,679137,0.729961284386709
6284,United Arab Emirates,ARE,2007,742789,258810,52479,232101,543390,0.7315536444400765
6285,United Arab Emirates,ARE,2006,607399,211785,42355,190949,445089,0.7327786183381928
6286,United Arab Emirates,ARE,2005,537379,187582,37150,169404,394136,0.7334413886660998
6287,United Arab Emirates,ARE,2004,512608,179216,35303,161603,376122,0.7337419626693301
6288,United Arab Emirates,ARE,2003,486489,170244,33346,153361,356951,0.7337288201788735
6289,United Arab Emirates,ARE,2002,460356,161135,31380,145059,337574,0.7332890198020662
6290,United Arab Emirates,ARE,2001,434993,152186,29473,136990,318649,0.732538224753042
6291,United Arab Emirates,ARE,2000,410680,143554,27668,129256,300478,0.7316596863738191
6292,United Arab Emirates,ARE,1999,387669,135244,25985,121973,283202,0.7305252676897044
6293,United Arab Emirates,ARE,1998,365787,127265,24412,115083,266760,0.7292768742464877
6294,United Arab Emirates,ARE,1997,345027,119678,22933,108592,251203,0.728067658473105
6295,United Arab Emirates,ARE,1996,325292,112495,21527,102367,236389,0.7266978591542368
6296,United Arab Emirates,ARE,1995,306168,105715,20174,96235,222124,0.7254971126962975
6297,United Arab Emirates,ARE,1994,287508,99253,18853,90209,208315,0.724553751547783
6298,United Arab Emirates,ARE,2019,1262939,417177,87989,416251,921417,0.7295815554037052
6299,United Arab Emirates,ARE,1993,269425,93052,17587,84360,194999,0.7237598589588939
6300,United Kingdom,GBR,1990,8312892,2462412,688359,2947494,6098265,0.7335912700417616
6301,United Kingdom,GBR,1992,8309380,2544150,689420,2856970,6090540,0.732971653721457
6302,United Kingdom,GBR,2017,9626858,3107402,808102,3140877,7056381,0.7329889980718527
6303,United Kingdom,GBR,2016,9616672,3098315,804185,3151307,7053807,0.7334977214570696
6304,United Kingdom,GBR,2015,9602895,3088906,799875,3159568,7048349,0.7339816794831142
6305,United Kingdom,GBR,2014,9527472,3073235,795318,3123630,6992183,0.7338969875744583
6306,United Kingdom,GBR,2013,9423926,3058792,790282,3063389,6912463,0.7335014090730338
6307,United Kingdom,GBR,2012,9308653,3044110,784891,2994047,6823048,0.7329790894557999
6308,United Kingdom,GBR,2011,9197295,3027454,779152,2930147,6736753,0.7324711233031016
6309,United Kingdom,GBR,2010,9106137,3007050,773095,2887210,6667355,0.7321825929041041
6310,United Kingdom,GBR,2009,9023197,2971095,766989,2864659,6602743,0.7317520608272212
6311,United Kingdom,GBR,2008,8931967,2917117,760690,2849489,6527296,0.7307792337342939
6312,United Kingdom,GBR,2007,8841507,2857746,754247,2839069,6451062,0.7296337603985384
6313,United Kingdom,GBR,2006,8761884,2805257,747736,2831815,6384808,0.7287026397519072
6314,United Kingdom,GBR,2005,8702299,2771562,741337,2825502,6338401,0.7283593680244727
6315,United Kingdom,GBR,2004,8669345,2754375,734735,2831167,6320277,0.7290374301634092
6316,United Kingdom,GBR,2003,8654434,2741978,727779,2852426,6322183,0.7305137459018117
6317,United Kingdom,GBR,2002,8645194,2731875,720951,2877668,6330494,0.7322558637781871
6318,United Kingdom,GBR,2001,8629433,2721817,714790,2894695,6331302,0.7336869061965021
6319,United Kingdom,GBR,2000,8596739,2710241,709750,2892570,6312561,0.7342971561658438
6320,United Kingdom,GBR,1999,8550656,2695030,705724,2875428,6276182,0.7340000580072453
6321,United Kingdom,GBR,1998,8500121,2676071,702254,2855709,6234034,0.7334053244653811
6322,United Kingdom,GBR,1997,8448420,2655790,699264,2835830,6190884,0.7327860120590596
6323,United Kingdom,GBR,1996,8401179,2637290,696649,2818557,6152496,0.7323372112414221
6324,United Kingdom,GBR,1995,8362038,2623256,694218,2805899,6123373,0.7322823694415165
6325,United Kingdom,GBR,1994,8334319,2606062,692017,2806414,6104493,0.7324525255152821
6326,United Kingdom,GBR,1993,8317015,2578697,690387,2824662,6093746,0.7326842623224799
6327,United Kingdom,GBR,1991,8308660,2504702,688823,2899270,6092795,0.733306574104609
6328,United Kingdom,GBR,2018,9674260,3126722,811798,3157062,7095582,0.7334495868417843
6329,United Kingdom,GBR,2019,9722512,3151915,815387,3177565,7144867,0.7348787021296553
6330,United States,USA,1992,39794290,14569301,1649893,11177042,27396236,0.6884464077635258
6331,United States,USA,2017,50740395,17984400,2098362,15119450,35202212,0.6937709491619054
6332,United States,USA,2016,50409293,17849898,2086265,15035806,34971969,0.693760354861553
6333,United States,USA,2015,50118178,17750889,2072833,14967077,34790799,0.6941752551339755
6334,United States,USA,2014,50067821,17847111,2058467,14936694,34842272,0.6959015052802078
6335,United States,USA,2013,50231546,18187973,2043358,14926103,35157434,0.6999074645243847
6336,United States,USA,2012,50472306,18630222,2028175,14916192,35574589,0.7048338350143938
6337,United States,USA,2011,50645621,19027419,2012107,14884267,35923793,0.7093168627550248
6338,United States,USA,2010,50602112,19240616,1994744,14801937,36037297,0.7121698201055323
6339,United States,USA,2009,50363277,19285938,1976775,14685303,35948016,0.7137743638087728
6340,United States,USA,2008,50035044,19281145,1957938,14555578,35794661,0.715391816183873
6341,United States,USA,2007,49677353,19266783,1938818,14417571,35623172,0.7170907838024301
6342,United States,USA,2006,49328867,19270408,1918659,14267343,35456410,0.7187760870323658
6343,United States,USA,1990,38255580,14237668,1622874,10355583,26216125,0.6852889173291844
6344,United States,USA,2005,49026090,19317883,1897554,14104829,35320266,0.7204381585396673
6345,United States,USA,1991,39022990,14397210,1635684,10769068,26801962,0.6868249203866746
6346,United States,USA,2004,48864859,19512214,1876111,13953672,35341997,0.7232599811656062
6347,United States,USA,2003,48809759,19835024,1854662,13822668,35512354,0.7275666737055596
6348,United States,USA,2002,48767409,20162524,1834044,13700564,35697132,0.7319874631846854
6349,United States,USA,2001,48602349,20360440,1813653,13564633,35738726,0.7353291915993607
6350,United States,USA,2000,48205944,20302762,1793133,13398768,35494663,0.7363129949285923
6351,United States,USA,1999,47323028,19653483,1773038,13220130,34646651,0.7321308983017739
6352,United States,USA,1998,45951398,18419409,1753295,13034894,33207598,0.7226678500619285
6353,United States,USA,1997,44413912,17006650,1734118,12830515,31571283,0.7108422018758447
6354,United States,USA,1996,43002512,15797534,1715683,12589049,30102266,0.7000118039615918
6355,United States,USA,1995,42003091,15165848,1697909,12288932,29152689,0.694060563304734
6356,United States,USA,1994,41292570,14950859,1680919,11941293,28573071,0.6919663997663502
6357,United States,USA,1993,40550816,14752255,1665014,11568770,27986039,0.6901473696608226
6358,United States,USA,2018,51544417,18736861,2110289,15202326,36049476,0.6993866280415976
6359,United States,USA,2019,52971851,20241173,2122116,15290457,37653746,0.7108255665825233
6360,United States Virgin Islands,VIR,2018,14846,4880,1020,4085,9985,0.6725717364946787
6361,United States Virgin Islands,VIR,1991,14553,4542,985,3390,8917,0.6127258984401841
6362,United States Virgin Islands,VIR,2017,14886,4893,1026,4066,9985,0.6707644766895069
6363,United States Virgin Islands,VIR,2016,14959,4919,1032,4071,10022,0.6699645698241861
6364,United States Virgin Islands,VIR,2015,15028,4944,1037,4079,10060,0.6694170881022092
6365,United States Virgin Islands,VIR,2014,15071,4951,1042,4069,10062,0.6676398380996617
6366,United States Virgin Islands,VIR,2013,15102,4950,1047,4047,10044,0.66507747318236
6367,United States Virgin Islands,VIR,2012,15127,4946,1051,4024,10021,0.6624578568123224
6368,United States Virgin Islands,VIR,2011,15155,4942,1056,4001,9999,0.659782250082481
6369,United States Virgin Islands,VIR,2010,15192,4943,1059,3987,9989,0.6575171142706687
6370,United States Virgin Islands,VIR,2009,15244,4946,1063,3982,9991,0.6554054054054054
6371,United States Virgin Islands,VIR,2008,15295,4945,1065,3981,9991,0.6532200065380843
6372,United States Virgin Islands,VIR,2007,15341,4942,1068,3979,9989,0.6511309562609999
6373,United States Virgin Islands,VIR,2006,15379,4938,1069,3972,9979,0.6488718382209506
6374,United States Virgin Islands,VIR,2019,14832,4875,1014,4128,10017,0.6753640776699029
6375,United States Virgin Islands,VIR,2005,15406,4933,1069,3955,9957,0.6463066337790472
6376,United States Virgin Islands,VIR,2003,15414,4925,1066,3891,9882,0.6411054885169326
6377,United States Virgin Islands,VIR,2002,15399,4918,1063,3850,9831,0.6384180790960452
6378,United States Virgin Islands,VIR,2001,15371,4904,1059,3806,9769,0.6355474595016589
6379,United States Virgin Islands,VIR,2000,15324,4883,1054,3764,9701,0.633059253458627
6380,United States Virgin Islands,VIR,1999,15258,4852,1048,3721,9621,0.6305544632324027
6381,United States Virgin Islands,VIR,1998,15171,4813,1041,3669,9523,0.6277107639575505
6382,United States Virgin Islands,VIR,1997,15068,4770,1033,3615,9418,0.6250331829041678
6383,United States Virgin Islands,VIR,1996,14964,4726,1025,3564,9315,0.6224939855653568
6384,United States Virgin Islands,VIR,1995,14858,4683,1017,3516,9216,0.6202719073899583
6385,United States Virgin Islands,VIR,1994,14764,4642,1009,3476,9127,0.6181929016526686
6386,United States Virgin Islands,VIR,1993,14682,4605,1001,3442,9048,0.6162648140580302
6387,United States Virgin Islands,VIR,1992,14613,4571,993,3414,8978,0.6143844522000959
6388,United States Virgin Islands,VIR,2004,15415,4930,1068,3926,9924,0.6437885176775867
6389,United States Virgin Islands,VIR,1990,14516,4517,978,3375,8870,0.6110498759988978
6390,Uruguay,URY,2005,442408,173226,34095,96951,304272,0.687763331585324
6391,Uruguay,URY,2011,452355,177406,35097,101421,313924,0.6939770755269644
6392,Uruguay,URY,2019,465322,184761,36212,108191,329164,0.707389721526169
6393,Uruguay,URY,2018,464155,183895,36101,108091,328087,0.7068479279551012
6394,Uruguay,URY,2017,463158,183250,35979,107865,327094,0.7062255213123815
6395,Uruguay,URY,2016,462601,182943,35847,107745,326535,0.7058674754269878
6396,Uruguay,URY,2015,462116,182569,35714,107495,325778,0.7049701806472833
6397,Uruguay,URY,2014,460427,181592,35569,106526,323687,0.7030148101653465
6398,Uruguay,URY,2013,457783,180237,35419,104880,320536,0.7001920123726744
6399,Uruguay,URY,2012,455010,178761,35264,103088,317113,0.6969363310696468
6400,Uruguay,URY,2010,450232,176391,34918,100193,311502,0.6918699692602924
6401,Uruguay,URY,2009,448595,175667,34735,99478,309880,0.6907789877283519
6402,Uruguay,URY,2008,447063,175039,34558,98814,308411,0.689860265779096
6403,Uruguay,URY,2006,444142,173892,34246,97638,305776,0.6884645000923129
6404,Uruguay,URY,2004,440122,172466,33749,96007,302222,0.6866777847960338
6405,Uruguay,URY,2007,445712,174481,34397,98230,307108,0.6890278924507305
6406,Uruguay,URY,2002,434026,170789,32453,93329,296571,0.68330238280656
6407,Uruguay,URY,1990,407068,159440,29741,83489,272670,0.6698389458272328
6408,Uruguay,URY,1991,408943,160581,29970,83449,274000,0.6700200272409602
6409,Uruguay,URY,1992,410904,161710,30192,83545,275447,0.6703439246149953
6410,Uruguay,URY,1993,412791,162794,30399,83722,276915,0.6708358467117742
6411,Uruguay,URY,1994,414853,163827,30593,84162,278582,0.6715197913477786
6412,Uruguay,URY,2003,437170,171646,33143,94764,299553,0.6852094151016767
6413,Uruguay,URY,1996,419106,165722,30945,85675,282342,0.6736768263875964
6414,Uruguay,URY,1995,417000,164798,30773,84779,280350,0.6723021582733812
6415,Uruguay,URY,1998,423404,167494,31256,88082,286832,0.677442820568535
6416,Uruguay,URY,1999,425683,168327,31396,89393,289116,0.6791814566238257
6417,Uruguay,URY,2000,428137,169125,31533,90641,291299,0.680387352646466
6418,Uruguay,URY,2001,430862,169938,31860,91907,293705,0.6816683764175072
6419,Uruguay,URY,1997,421247,166621,31106,86814,284541,0.6754730597487935
6420,Uzbekistan,UZB,2000,2527934,477617,114495,664578,1256690,0.49712136471917384
6421,Uzbekistan,UZB,1996,2312164,434038,103568,610079,1147685,0.49636833719407447
6422,Uzbekistan,UZB,1999,2475596,466767,111593,650014,1228374,0.4961932399309096
6423,Uzbekistan,UZB,1998,2421826,455731,108799,636390,1200920,0.49587377458165866
6424,Uzbekistan,UZB,1997,2366979,444759,106125,623024,1173908,0.4959520130934833
6425,Uzbekistan,UZB,1995,2257114,423715,101107,597415,1122237,0.49719996420207396
6426,Uzbekistan,UZB,2003,2666553,508684,123650,712922,1345256,0.5044925039929827
6427,Uzbekistan,UZB,1993,2148952,403916,96415,573172,1073503,0.49954722115710354
6428,Uzbekistan,UZB,1992,2094209,394254,94127,561049,1049430,0.5011104431315117
6429,Uzbekistan,UZB,1991,2039266,384762,91873,548543,1025178,0.5027191156033592
6430,Uzbekistan,UZB,1990,1985432,375518,89660,536030,1001208,0.5042771547955306
6431,Uzbekistan,UZB,2001,2576486,488188,117479,680193,1285860,0.4990750968567266
6432,Uzbekistan,UZB,1994,2202794,413721,98736,585193,1097650,0.49829897847914967
6433,Uzbekistan,UZB,2002,2623228,498548,120536,696251,1315335,0.5014184813519831
6434,Uzbekistan,UZB,2005,2749202,528378,129999,745177,1403554,0.5105314196628694
6435,Uzbekistan,UZB,2019,3307343,670593,172580,990616,1833789,0.5544598791235139
6436,Uzbekistan,UZB,2018,3255690,657564,169743,972589,1799896,0.5528462476464282
6437,Uzbekistan,UZB,2017,3207588,645656,166926,954451,1767033,0.5508915110045305
6438,Uzbekistan,UZB,2016,3162809,634344,164109,937088,1735541,0.5487340525463282
6439,Uzbekistan,UZB,2015,3121772,623440,161273,919544,1704257,0.5459261598861159
6440,Uzbekistan,UZB,2004,2708620,518629,126811,728988,1374428,0.5074273984538252
6441,Uzbekistan,UZB,2013,3038213,603648,155368,880349,1639365,0.539581984541571
6442,Uzbekistan,UZB,2014,3079341,613351,158342,899991,1671684,0.5428706986332466
6443,Uzbekistan,UZB,2011,2961360,584903,149267,840973,1575143,0.5318985195991032
6444,Uzbekistan,UZB,2010,2923512,575481,146125,821753,1543359,0.5279126612102156
6445,Uzbekistan,UZB,2009,2887004,566054,142893,804802,1513749,0.5243321450195427
6446,Uzbekistan,UZB,2008,2854312,556747,139653,790032,1486432,0.5207671761180979
6447,Uzbekistan,UZB,2007,2822136,547426,136416,775745,1459587,0.5171922968985194
6448,Uzbekistan,UZB,2006,2787823,537975,133188,761338,1432501,0.5138421628632808
6449,Uzbekistan,UZB,2012,2999218,594223,152345,860566,1607134,0.5358510118304172
6450,Vanuatu,VUT,2002,21812,7209,444,4876,12529,0.574408582431689
6451,Vanuatu,VUT,2001,21212,7020,430,4734,12184,0.5743918536677353
6452,Vanuatu,VUT,2000,20632,6828,417,4598,11843,0.5740112446684762
6453,Vanuatu,VUT,1999,20081,6633,405,4472,11510,0.5731786265624222
6454,Vanuatu,VUT,1998,19559,6440,393,4355,11188,0.5720128840942789
6455,Vanuatu,VUT,1990,15964,5184,315,3535,9034,0.5658982711099975
6456,Vanuatu,VUT,1996,18581,6078,371,4134,10583,0.56956030353587
6457,Vanuatu,VUT,1995,18109,5912,360,4026,10298,0.5686675133911315
6458,Vanuatu,VUT,1994,17655,5755,350,3920,10025,0.567827810818465
6459,Vanuatu,VUT,1993,17210,5604,341,3817,9762,0.5672283556072051
6460,Vanuatu,VUT,1992,16788,5458,332,3720,9510,0.5664760543245175
6461,Vanuatu,VUT,2003,22420,7400,458,5020,12878,0.5743978590544156
6462,Vanuatu,VUT,1997,19065,6254,381,4243,10878,0.5705743509047994
6463,Vanuatu,VUT,2004,23048,7599,472,5172,13243,0.574583477959042
6464,Vanuatu,VUT,2012,28100,9491,589,6378,16458,0.5856939501779359
6465,Vanuatu,VUT,2006,24338,8045,502,5483,14030,0.5764647875749856
6466,Vanuatu,VUT,2007,24966,8291,517,5629,14437,0.5782664423616118
6467,Vanuatu,VUT,2008,25598,8542,532,5779,14853,0.5802406438002969
6468,Vanuatu,VUT,2009,26221,8790,546,5928,15264,0.582128828038595
6469,Vanuatu,VUT,2010,26847,9026,561,6078,15665,0.5834916377993817
6470,Vanuatu,VUT,2011,27469,9256,575,6231,16062,0.5847318795733372
6471,Vanuatu,VUT,2013,28726,9729,603,6524,16856,0.5867854904964144
6472,Vanuatu,VUT,2014,29363,9965,617,6670,17252,0.5875421448762047
6473,Vanuatu,VUT,2015,30000,10195,630,6817,17642,0.5880666666666666
6474,Vanuatu,VUT,2016,30614,10399,644,6966,18009,0.5882602730776769
6475,Vanuatu,VUT,2017,31228,10606,658,7115,18379,0.5885423338029974
6476,Vanuatu,VUT,2018,31918,10858,673,7282,18813,0.5894166301146688
6477,Vanuatu,VUT,2019,32643,11144,687,7462,19293,0.5910302361915265
6478,Vanuatu,VUT,2005,23687,7813,487,5327,13627,0.5752944653185291
6479,Vanuatu,VUT,1991,16370,5318,323,3626,9267,0.5660965180207697
6480,Venezuela,VEN,2005,3296579,965323,210731,760980,1937034,0.5875891340689848
6481,Venezuela,VEN,1990,2301773,662707,142530,488782,1294019,0.5621835863049919
6482,Venezuela,VEN,1992,2430533,700372,150869,521562,1372803,0.5648156186317981
6483,Venezuela,VEN,1993,2496063,719641,155175,538665,1413481,0.5662841843334884
6484,Venezuela,VEN,1994,2561541,739000,159525,555773,1454298,0.567743401335368
6485,Venezuela,VEN,1995,2626342,758363,163909,573242,1495514,0.5694285055030913
6486,Venezuela,VEN,1996,2691885,777924,168346,591100,1537370,0.571112807567931
6487,Venezuela,VEN,1997,2757608,797824,172847,609433,1580104,0.5729980475832678
6488,Venezuela,VEN,1998,2824978,817993,177402,628423,1623818,0.5748073082339048
6489,Venezuela,VEN,1999,2889559,837810,181860,646678,1666348,0.5766790018822942
6490,Venezuela,VEN,2000,2954935,857753,186347,664984,1709084,0.5783829424335899
6491,Venezuela,VEN,2001,3022855,878665,191006,683990,1753661,0.580134012382334
6492,Venezuela,VEN,2002,3090907,900111,195735,702423,1798269,0.5817933053307653
6493,Venezuela,VEN,2003,3160325,921764,200568,721259,1843591,0.5833548764763118
6494,Venezuela,VEN,2004,3228535,943547,205560,740724,1889831,0.5853524895966746
6495,Venezuela,VEN,2006,3362852,987267,216005,780820,1984092,0.5900027714570847
6496,Venezuela,VEN,2007,3427513,1009713,221288,800478,2031479,0.5926976790460021
6497,Venezuela,VEN,2008,3491193,1032489,226508,820041,2079038,0.5955093287595387
6498,Venezuela,VEN,2009,3555054,1055477,231647,839582,2126706,0.5982204489720832
6499,Venezuela,VEN,2010,3620085,1078576,236731,860293,2175600,0.6009803637207414
6500,Venezuela,VEN,2011,3686263,1103008,241745,881778,2226531,0.604007635917459
6501,Venezuela,VEN,2012,3749631,1129344,246615,903430,2279389,0.6078968837200247
6502,Venezuela,VEN,2013,3814970,1156686,251339,924982,2333007,0.6115400645352388
6503,Venezuela,VEN,2014,3879143,1183550,255825,946401,2385776,0.6150265664349058
6504,Venezuela,VEN,2015,3925195,1203583,258899,963124,2425606,0.617958088706421
6505,Venezuela,VEN,2016,3862271,1190855,254176,956984,2402015,0.6219177784262161
6506,Venezuela,VEN,2017,3721531,1152801,244060,934206,2331067,0.6263731243942345
6507,Venezuela,VEN,1991,2366086,681371,146646,505005,1333022,0.5633869605753975
6508,Venezuela,VEN,2018,3689181,1144237,241448,933972,2319657,0.628772890243119
6509,Venezuela,VEN,2019,3739364,1160696,244764,951393,2356853,0.6302817805380808
6510,Vietnam,VNM,1991,6674273,1434746,200680,1468202,3103628,0.4650136426843793
6511,Vietnam,VNM,2017,9064990,2281722,349445,2547891,5179058,0.5713252855215505
6512,Vietnam,VNM,2016,8992117,2263517,345210,2505284,5114011,0.5687215813584277
6513,Vietnam,VNM,2015,8919049,2242766,340873,2462610,5046249,0.5657833026817096
6514,Vietnam,VNM,2014,8819617,2187508,336364,2422122,4945994,0.5607946467516673
6515,Vietnam,VNM,2013,8694494,2095911,331702,2382510,4810123,0.5532378307466771
6516,Vietnam,VNM,2012,8559864,1992442,326804,2342011,4661257,0.5445480208564061
6517,Vietnam,VNM,2011,8437889,1901579,321661,2301668,4524908,0.5362606689896016
6518,Vietnam,VNM,2010,8350786,1847477,316300,2261725,4425502,0.5299503543738278
6519,Vietnam,VNM,2009,8285256,1819575,310703,2221440,4351718,0.5252363958337558
6520,Vietnam,VNM,2008,8221980,1791989,304859,2182781,4279629,0.5205107528843417
6521,Vietnam,VNM,2007,8155495,1764571,298786,2142265,4205622,0.5156795510266391
6522,Vietnam,VNM,2006,8089602,1736961,292452,2101682,4131095,0.5106672738658836
6523,Vietnam,VNM,2018,9141356,2308091,353570,2589019,5250680,0.5743874322365303
6524,Vietnam,VNM,2005,8013221,1709291,285940,2056190,4051421,0.5055920709038225
6525,Vietnam,VNM,2004,7952646,1703876,279405,2012433,3995714,0.5024383079543588
6526,Vietnam,VNM,2003,7914377,1728176,272878,1968770,3969824,0.5015965249065087
6527,Vietnam,VNM,2002,7873147,1760472,266341,1924501,3951314,0.5018722500672221
6528,Vietnam,VNM,2001,7819304,1780409,259848,1879330,3919587,0.5012705734423422
6529,Vietnam,VNM,2000,7736974,1768646,253415,1833276,3855337,0.49830036911071435
6530,Vietnam,VNM,1999,7631094,1733183,247011,1787671,3767865,0.49375161674066653
6531,Vietnam,VNM,1998,7519203,1695495,240650,1740559,3676704,0.4889752278266726
6532,Vietnam,VNM,1997,7400858,1656739,234397,1693672,3584808,0.48437735192325
6533,Vietnam,VNM,1996,7278673,1617759,228271,1649920,3495950,0.4803004613615696
6534,Vietnam,VNM,1995,7157067,1579557,222322,1608804,3410683,0.47654758576383316
6535,Vietnam,VNM,1994,7033874,1542291,216608,1569745,3328644,0.4732305412351714
6536,Vietnam,VNM,1993,6911565,1505549,211087,1534096,3250732,0.4703322619406748
6537,Vietnam,VNM,1992,6790616,1469651,205782,1500108,3175541,0.4676366621231417
6538,Vietnam,VNM,1990,6557053,1400633,195722,1437238,3033593,0.4626457952985892
6539,Vietnam,VNM,2019,9222038,2339297,357610,2629101,5326008,0.5775304764521682
6540,Wales,,1991,411885,126840,28788,145430,301058,0.7309273219466599
6541,Wales,,2018,441063,139834,32360,151791,323985,0.7345549275273601
6542,Wales,,1992,410972,126771,28775,144540,300086,0.7301859980728614
6543,Wales,,1993,410362,126790,28772,143819,299381,0.7295534186888649
6544,Wales,,1994,410195,126917,28793,143303,299013,0.7289533026974976
6545,Wales,,1995,410412,127140,28839,142986,298965,0.7284509224876465
6546,Wales,,1996,410989,127491,28892,142988,299371,0.7284160889950826
6547,Wales,,1997,411691,127984,28951,142955,299890,0.728434675521204
6548,Wales,,1998,412687,128562,29026,143076,300664,0.7285521472689956
6549,Wales,,1999,413674,129147,29118,143149,301414,0.7286268897731064
6550,Wales,,2000,414616,129691,29234,143213,302138,0.7287176568198044
6551,Wales,,2001,415163,130187,29383,142705,302275,0.7280875222502968
6552,Wales,,2002,415123,130644,29571,141605,301820,0.727061617881929
6553,Wales,,2003,414871,131094,29786,140236,301116,0.7258063349812351
6554,Wales,,2019,442937,140760,32428,152621,325809,0.7355651029378896
6555,Wales,,2004,415056,131593,30014,139285,300892,0.7249431402027678
6556,Wales,,2006,417705,132960,30457,139645,303062,0.7255407524449073
6557,Wales,,2007,419376,133824,30683,140182,304689,0.7265294151310518
6558,Wales,,2008,421200,134702,30903,140896,306501,0.7276851851851852
6559,Wales,,2009,422952,135536,31114,141623,308273,0.7288604853505836
6560,Wales,,2010,425003,136265,31311,142530,310106,0.7296560259574638
6561,Wales,,2011,427377,137016,31500,143786,312302,0.7307412425095408
6562,Wales,,2012,430197,137858,31675,145409,314942,0.7320878574234595
6563,Wales,,2013,433025,138700,31830,147082,317612,0.7334726632411523
6564,Wales,,2014,435645,139455,31970,148634,320059,0.7346784652641486
6565,Wales,,2015,437674,140006,32090,149695,321791,0.7352298742899966
6566,Wales,,2016,438735,139702,32197,150431,322330,0.7346803879334906
6567,Wales,,2017,439504,139338,32286,151086,322710,0.7342595289235138
6568,Wales,,2005,416089,132200,30236,139162,301598,0.7248401183400667
6569,Wales,,1990,412877,126977,28801,146393,302171,0.731866875607021
6570,Western Pacific Region (WHO),,2005,202799584,61621078,5118258,54839859,121579195,0.59950416367718
6571,Western Pacific Region (WHO),,2019,215928977,65879289,5718999,64375091,135973379,0.629713440452228
6572,Western Pacific Region (WHO),,2016,212159485,64202521,5630998,62517962,132351481,0.6238301389164854
6573,Western Pacific Region (WHO),,2015,210096585,62934594,5595558,61733126,130263278,0.6200161606624877
6574,Western Pacific Region (WHO),,2014,209001665,62738418,5557364,60812507,129108289,0.6177380883544635
6575,Western Pacific Region (WHO),,2013,208245397,62881074,5517562,59836465,128235101,0.6157884056376045
6576,Western Pacific Region (WHO),,2012,207646497,63158417,5475353,58858427,127492197,0.6139867459454421
6577,Western Pacific Region (WHO),,2011,207061444,63377997,5430599,57919599,126728195,0.612031832444866
6578,Western Pacific Region (WHO),,2010,206327230,63358926,5382646,57059123,125800695,0.6097144569817566
6579,Western Pacific Region (WHO),,2009,205558929,63092148,5333402,56427952,124853502,0.6073854471191568
6580,Western Pacific Region (WHO),,2008,204913430,62720476,5284203,56033414,124038093,0.605319490284263
6581,Western Pacific Region (WHO),,2007,204295938,62313347,5232648,55742823,123288818,0.6034814945757757
6582,Western Pacific Region (WHO),,2006,203619673,61929287,5178085,55400012,122507384,0.601648073563108
6583,Western Pacific Region (WHO),,2004,202189161,61765228,5049630,54062720,120877578,0.5978440060889317
6584,Western Pacific Region (WHO),,2017,214307370,65570314,5662442,63251524,134484280,0.6275298884961352
6585,Western Pacific Region (WHO),,2003,201920996,62412417,4973679,53167723,120553819,0.5970345897065603
6586,Western Pacific Region (WHO),,2001,200983979,63610088,4819180,51354847,119784115,0.5959883747748869
6587,Western Pacific Region (WHO),,2000,199688569,63412507,4748512,50577410,118738429,0.5946180574812973
6588,Western Pacific Region (WHO),,1999,197877862,62516170,4683507,50071541,117271218,0.5926444566092998
6589,Western Pacific Region (WHO),,1998,195849503,61257137,4619461,49807132,115683730,0.5906766584952733
6590,Western Pacific Region (WHO),,1997,193684024,59881927,4555765,49615386,114053078,0.5888615676427705
6591,Western Pacific Region (WHO),,1996,191420280,58607299,4493372,49329282,112429953,0.5873460899754195
6592,Western Pacific Region (WHO),,1995,189080306,57611715,4431640,48775829,110819184,0.5860958570693238
6593,Western Pacific Region (WHO),,1994,186546480,56844558,4370944,47972492,109187994,0.5853125398024128
6594,Western Pacific Region (WHO),,1993,183744614,56124029,4309603,47018375,107452007,0.5847899683198333
6595,Western Pacific Region (WHO),,1992,180700225,55443868,4247710,45922161,105613739,0.5844693275838477
6596,Western Pacific Region (WHO),,1991,177458802,54790589,4183680,44675378,103649647,0.5840772383891107
6597,Western Pacific Region (WHO),,1990,174024170,54154246,4116684,43278116,101549046,0.5835341493081104
6598,Western Pacific Region (WHO),,2002,201630095,63157960,4895757,52241218,120294935,0.5966120037785034
6599,Western Pacific Region (WHO),,2018,215445883,65956761,5691958,63902356,135551075,0.62916530644496
6600,World,OWID_WRL,2018,959438272,297561347,39039917,275435653,612036917,0.6379117186186211
6601,World,OWID_WRL,1990,654823716,194923302,24798455,170797771,390519528,0.59637352535961
6602,World,OWID_WRL,2016,936289746,288720795,38027452,266755878,593504125,0.6338893782993539
6603,World,OWID_WRL,2015,924444487,283998216,37519129,262439139,583956484,0.6316836675559081
6604,World,OWID_WRL,2014,913998060,280791044,37008058,258034785,575833887,0.6300165308884791
6605,World,OWID_WRL,2013,904334250,278436035,36495443,253663416,568594894,0.6287441772773729
6606,World,OWID_WRL,2012,894950961,276367094,35977135,249369026,561713255,0.6276469655637367
6607,World,OWID_WRL,2011,885493783,274075303,35455709,245180368,554711380,0.6264429978499352
6608,World,OWID_WRL,2010,875629029,271080462,34932496,241178646,547191604,0.624912589552807
6609,World,OWID_WRL,2009,866251626,267105137,34409309,238541969,540056415,0.6234405786846974
6610,World,OWID_WRL,2008,857738813,262456611,33878863,237501906,533837380,0.6223775488634674
6611,World,OWID_WRL,2007,849157016,257562353,33334799,236862880,527760032,0.6215105358088451
6612,World,OWID_WRL,2006,840013303,252921634,32787018,235550104,521258756,0.6205363107207839
6613,World,OWID_WRL,2005,830117952,249047872,32244960,232640256,513933088,0.6191085095338354
6614,World,OWID_WRL,2019,970070243,301390391,39546461,279606279,620543131,0.6396888632321444
6615,World,OWID_WRL,2004,819788292,246027215,31693378,228471295,506191888,0.6174665983153611
6616,World,OWID_WRL,2002,799122154,240811229,30561718,219621516,490994463,0.6144172834432519
6617,World,OWID_WRL,2001,788405348,237892096,30008963,215291769,483192828,0.612873605215575
6618,World,OWID_WRL,2000,777263129,234329924,29483995,211235857,475049776,0.6111826976936147
6619,World,OWID_WRL,1999,765581961,229857624,28983094,207600392,466441110,0.6092634541581107
6620,World,OWID_WRL,1998,753445783,224776004,28491557,204234754,457502315,0.607213319554806
6621,World,OWID_WRL,1997,741121571,219599771,28004671,200962784,448567226,0.6052545811002983
6622,World,OWID_WRL,1996,728846460,214815134,27522585,197590067,439927786,0.6035945979623747
6623,World,OWID_WRL,1995,717013653,210899715,27049023,193973561,431922299,0.6023906200291
6624,World,OWID_WRL,1994,705306770,207614827,26588055,189998906,424201788,0.6014429550988146
6625,World,OWID_WRL,1993,693152599,204386465,26134913,185628281,416149659,0.6003723561022095
6626,World,OWID_WRL,1992,680642977,201206981,25687265,180947797,407842043,0.5992011330192569
6627,World,OWID_WRL,1991,667839250,198056264,25241287,175980993,399278544,0.5978662440100668
6628,World,OWID_WRL,2003,809513560,243403789,31127668,224065814,498597271,0.6159220742392505
6629,World,OWID_WRL,2017,948318346,293548356,38533575,271096772,603178703,0.6360508636621905
6630,World Bank High Income,,1990,139367284,49999286,7940798,38041068,95981152,0.6886921323658715
6631,World Bank High Income,,1991,140520205,50348890,8001660,38491925,96842475,0.6891711764866839
6632,World Bank High Income,,2011,165637744,60318348,9468966,47570822,117358136,0.7085229076773709
6633,World Bank High Income,,2018,170284926,61381276,9836568,49257382,120475226,0.7074920184068436
6634,World Bank High Income,,2017,169042138,60519414,9795629,48918053,119233096,0.7053454092020535
6635,World Bank High Income,,2016,168321525,60297766,9749346,48647157,118694269,0.7051639355097336
6636,World Bank High Income,,2015,167604175,60100938,9697748,48381622,118180308,0.7051155378438514
6637,World Bank High Income,,2014,166967712,59969905,9644640,48144550,117759095,0.7052806413254318
6638,World Bank High Income,,2013,166537772,60052766,9590263,47968131,117611160,0.7062131226302223
6639,World Bank High Income,,2012,166156361,60216163,9532430,47801403,117549996,0.7074661198195115
6640,World Bank High Income,,2019,172082256,62917018,9873815,49658753,122449586,0.7115758989119715
6641,World Bank High Income,,2010,164873138,60240541,9401902,47241004,116883447,0.7089295953110324
6642,World Bank High Income,,2009,163773566,59881755,9333886,46821375,116037016,0.7085210320205154
6643,World Bank High Income,,2008,162301323,59270765,9256894,46321508,114849167,0.7076292717589246
6644,World Bank High Income,,2006,159200261,57974237,9093997,45294830,112363064,0.7057969835866036
6645,World Bank High Income,,2005,157993321,57585632,9014319,44849057,111449008,0.7054032872693397
6646,World Bank High Income,,2007,160687427,58579124,9174675,45792044,113545843,0.706625559447162
6647,World Bank High Income,,2003,156446091,57545216,8827169,44203461,110575846,0.7067983948541099
6648,World Bank High Income,,1992,141686228,50703419,8062933,38966379,97732731,0.6897828559597197
6649,World Bank High Income,,1993,142836520,51052625,8122591,39452408,98627624,0.6904930475763481
6650,World Bank High Income,,1994,143974520,51401251,8181836,39953948,99537035,0.6913517405718734
6651,World Bank High Income,,2004,157135012,57483475,8926152,44492847,110902474,0.7057782513804116
6652,World Bank High Income,,1996,146595573,52495079,8302430,41024653,101822162,0.6945786964521773
6653,World Bank High Income,,1997,148536335,53768138,8363639,41605867,103737644,0.6983991088779725
6654,World Bank High Income,,1995,145113835,51756943,8241546,40472662,100471151,0.6923609385693652
6655,World Bank High Income,,1999,152571899,56554033,8489569,42736905,107780507,0.7064243658656959
6656,World Bank High Income,,2000,154050899,57353774,8555827,43226549,109136150,0.7084421493703844
6657,World Bank High Income,,2001,155059957,57616977,8634712,43626551,109878240,0.7086177639014823
6658,World Bank High Income,,2002,155818698,57637965,8727763,43936195,110301923,0.7078863089973965
6659,World Bank High Income,,1998,150632197,55239493,8426220,42186075,105851788,0.7027168832968691
6660,World Bank Low Income,,1999,47349818,12922336,1812980,14233458,28968774,0.6118032808489359
6661,World Bank Low Income,,2003,52689357,14387177,2028816,15799373,32215366,0.6114207466984272
6662,World Bank Low Income,,2002,51314204,14010390,1971460,15392910,31374760,0.6114244703084549
6663,World Bank Low Income,,2001,49906080,13626939,1913840,14981762,30522541,0.6115996487802688
6664,World Bank Low Income,,2000,48585937,13261897,1860743,14596005,29718645,0.6116717477322707
6665,World Bank Low Income,,1998,46136540,12599767,1767759,13873973,28241499,0.612128672848029
6666,World Bank Low Income,,2004,54076462,14773730,2087097,16213165,33073992,0.6116153087086208
6667,World Bank Low Income,,1996,43540425,11928496,1672306,13110946,26711748,0.613493046978756
6668,World Bank Low Income,,1995,42198510,11582272,1622245,12719606,25924123,0.614337401960401
6669,World Bank Low Income,,1994,40912829,11250444,1574206,12351119,25175769,0.6153514585852765
6670,World Bank Low Income,,1993,39706891,10942634,1529267,12010327,24482228,0.6165737831249493
6671,World Bank Low Income,,1992,38538045,10644700,1485338,11689377,23819415,0.618075333089678
6672,World Bank Low Income,,1997,44881577,12273021,1721584,13504235,27498840,0.6126977222747766
6673,World Bank Low Income,,2005,55498233,15184730,2147461,16639665,33971856,0.6121250022500716
6674,World Bank Low Income,,2019,79488654,23140158,3275816,24676471,51092445,0.6427639974882453
6675,World Bank Low Income,,2007,58311490,16049042,2273525,17471605,35794172,0.6138442355014423
6676,World Bank Low Income,,2008,59774035,16517440,2342220,17896754,36756414,0.6149227503212724
6677,World Bank Low Income,,2009,61274291,17003787,2413180,18345914,37762881,0.6162924186262718
6678,World Bank Low Income,,2010,62844556,17513429,2486539,18836393,38836361,0.6179749444009119
6679,World Bank Low Income,,2011,64469455,18063305,2562423,19365520,39991248,0.6203131079671761
6680,World Bank Low Income,,2012,66141822,18663310,2641834,19917955,41223099,0.6232531513873325
6681,World Bank Low Income,,2013,67833404,19288627,2723115,20486356,42498098,0.6265069345480584
6682,World Bank Low Income,,2014,69527992,19912292,2804737,21071838,43788867,0.6298019796113197
6683,World Bank Low Income,,2015,71282396,20524435,2888566,21695243,45108244,0.6328104347109769
6684,World Bank Low Income,,2016,73172176,21170643,2978125,22372015,46520783,0.6357714850519137
6685,World Bank Low Income,,2017,75198434,21844566,3073951,23094590,48013107,0.6384854636733526
6686,World Bank Low Income,,2018,77310785,22499527,3173452,23864236,49537215,0.6407542621640694
6687,World Bank Low Income,,1991,37328353,10336414,1439861,11357602,23133877,0.619740094078086
6688,World Bank Low Income,,2006,56890554,15604843,2208481,17055514,34868838,0.6129108533553742
6689,World Bank Low Income,,1990,36210108,10052794,1397945,11042734,22493473,0.6211932038424188
6690,World Bank Lower Middle Income,,1992,243555440,57849895,7112378,63301735,128264008,0.5266316695697703
6691,World Bank Lower Middle Income,,2019,390027180,104710085,13120832,108211665,226042582,0.5795559735093334
6692,World Bank Lower Middle Income,,1993,249126253,59041359,7284581,65621868,131947808,0.5296423255721668
6693,World Bank Lower Middle Income,,1994,254552950,60235549,7460499,67730359,135426407,0.5320166472240844
6694,World Bank Lower Middle Income,,1995,259763830,61443095,7640421,69543150,138626666,0.5336642364720292
6695,World Bank Lower Middle Income,,1996,264618908,62440592,7826598,71129310,141396500,0.5343401235712151
6696,World Bank Lower Middle Income,,1997,269122522,63125009,8017569,72629483,143772061,0.5342253035217914
6697,World Bank Lower Middle Income,,1998,273514063,63717832,8212632,74119544,146050008,0.5339762292222612
6698,World Bank Lower Middle Income,,1999,278112310,64471980,8412653,75686590,148571223,0.5342130414867289
6699,World Bank Lower Middle Income,,2000,283228111,65652754,8617273,77411532,151681559,0.5355455659554923
6700,World Bank Lower Middle Income,,2001,288917510,67197605,8825985,79403088,155426678,0.5379621262830349
6701,World Bank Lower Middle Income,,2002,294930890,68851152,9038859,81609118,159499129,0.5408017078170415
6702,World Bank Lower Middle Income,,2003,301168940,70594732,9256937,83936310,163787979,0.5438408721696202
6703,World Bank Lower Middle Income,,2004,307467580,72406948,9481325,86258092,168146365,0.5468751046858339
6704,World Bank Lower Middle Income,,1991,237896601,56653188,6943723,60840475,124437386,0.5230734086864907
6705,World Bank Lower Middle Income,,1990,232180471,55441606,6778129,58291173,120510908,0.5190398119228554
6706,World Bank Lower Middle Income,,2007,323689409,79170124,10177851,89408898,178756873,0.5522481367315913
6707,World Bank Lower Middle Income,,2008,327891138,82101084,10410432,88681928,181193444,0.5526024433145857
6708,World Bank Lower Middle Income,,2009,332297891,84946157,10645874,88277435,183869466,0.5533272132623918
6709,World Bank Lower Middle Income,,2010,337440367,87347751,10882179,89120337,187350267,0.5552100024831943
6710,World Bank Lower Middle Income,,2011,343187645,89404458,11115099,90952659,191472216,0.5579228121688355
6711,World Bank Lower Middle Income,,2012,349032261,91477228,11347215,92879720,195704163,0.5607050833619074
6712,World Bank Lower Middle Income,,2013,354983470,93571847,11584132,94896423,200052402,0.5635541339431946
6713,World Bank Lower Middle Income,,2014,361012720,95670611,11827679,97009947,204508237,0.5664848512816945
6714,World Bank Lower Middle Income,,2015,367049636,97741617,12077952,99200131,209019700,0.5694589491433252
6715,World Bank Lower Middle Income,,2016,373047392,99803772,12332236,101430779,213566787,0.5724923738375847
6716,World Bank Lower Middle Income,,2017,379063680,101829554,12591089,103704843,218125486,0.5754323020343178
6717,World Bank Lower Middle Income,,2018,384748206,103477627,12854217,105980179,222312023,0.5778117208426957
6718,World Bank Lower Middle Income,,2006,319114414,76462550,9946493,89584318,175993361,0.5515055205246856
6719,World Bank Lower Middle Income,,2005,313664772,74259613,9712969,88434857,172407439,0.549655091646696
6720,World Bank Upper Middle Income,,1990,246689908,79313345,8663052,63327666,151304063,0.6133370603875696
6721,World Bank Upper Middle Income,,2018,326510865,110009249,13145884,96177297,219332430,0.6717461913556843
6722,World Bank Upper Middle Income,,2019,327880235,110426345,13245782,96899561,220571688,0.6727202937377423
6723,World Bank Upper Middle Income,,2017,324438446,109164005,13043518,95225646,217433169,0.6701831169540247
6724,World Bank Upper Middle Income,,2016,321179786,107260168,12938746,94154743,214353657,0.6673946068324487
6725,World Bank Upper Middle Income,,2015,317945705,105445015,12826223,93013244,211284482,0.6645300712585502
6726,World Bank Upper Middle Income,,2014,315932887,105054415,12702668,91661723,209418806,0.6628585203287178
6727,World Bank Upper Middle Income,,2013,314428227,105341388,12569871,90167809,208079068,0.6617696826563857
6728,World Bank Upper Middle Income,,2012,313074307,105831395,12427854,88627231,206886480,0.6608222884287979
6729,World Bank Upper Middle Income,,2011,311657945,106112577,12281691,87150629,205544897,0.6595207993173413
6730,World Bank Upper Middle Income,,2009,308374731,105101290,11989419,84960112,202050821,0.6552119894674509
6731,World Bank Upper Middle Income,,2008,307247176,104398024,11842744,84466387,200707155,0.653243286441142
6732,World Bank Upper Middle Income,,2007,305950479,103597962,11682601,84056913,199337476,0.6515351002277725
6733,World Bank Upper Middle Income,,2006,304297686,102717254,11512362,83484142,197713758,0.6497379608729591
6734,World Bank Upper Middle Income,,2005,302459545,101858385,11345009,82587735,195791129,0.6473299726745274
6735,World Bank Upper Middle Income,,2010,309934799,105804280,12134619,85842034,203780933,0.6574961367923065
6736,World Bank Upper Middle Income,,2003,298725859,100723704,10990604,80003055,191717363,0.6417836194087235
6737,World Bank Upper Middle Income,,1991,251711098,80599088,8837127,65194037,154630252,0.6143163858432654
6738,World Bank Upper Middle Income,,2004,300616120,101206745,11174117,81380830,193761692,0.6445485757716519
6739,World Bank Upper Middle Income,,1992,256473612,81887994,9007348,66891677,157787019,0.6152173620107163
6740,World Bank Upper Middle Income,,1993,261086800,83226644,9178879,68443447,160848970,0.6160746924011479
6741,World Bank Upper Middle Income,,1994,265463654,84602083,9351587,69861570,163815240,0.6170910312264443
6742,World Bank Upper Middle Income,,1996,273673703,87820374,9700568,72219306,169740248,0.6202285646714109
6743,World Bank Upper Middle Income,,1995,269527410,85989448,9524522,71134344,166648314,0.6182982057372198
6744,World Bank Upper Middle Income,,1998,282728404,93082576,10063393,73944811,177090780,0.6263635966338919
6745,World Bank Upper Middle Income,,1999,287104396,95769838,10245869,74830682,180846389,0.6298976662133727
6746,World Bank Upper Middle Income,,2000,290945261,97918813,10427637,75886471,184232921,0.6332219344861575
6747,World Bank Upper Middle Income,,2001,294059035,99304531,10611392,77162388,187078311,0.6361930385849223
6748,World Bank Upper Middle Income,,2002,296585321,100162231,10800055,78562508,189524794,0.6390228395693258
6749,World Bank Upper Middle Income,,1997,278155108,90300213,9880773,73115147,173296133,0.623019775714491
6750,Yemen,YEM,2009,3396776,1072544,145074,914592,2132210,0.6277158105215063
6751,Yemen,YEM,2006,3131149,977854,131154,827125,1936133,0.6183458532315134
6752,Yemen,YEM,2007,3215446,1008425,135718,855228,1999371,0.6218020766015041
6753,Yemen,YEM,2008,3303339,1039935,140354,884591,2064880,0.625088735972905
6754,Yemen,YEM,2010,3500725,1106394,149887,945960,2202241,0.629081404566197
6755,Yemen,YEM,2016,4260640,1325671,181681,1154235,2661587,0.6246918303353487
6756,Yemen,YEM,2012,3729770,1176988,159830,1011913,2348731,0.6297254254283776
6757,Yemen,YEM,2013,3853214,1213657,165031,1046420,2425108,0.6293727781535103
6758,Yemen,YEM,2014,3980497,1251273,170418,1081971,2503662,0.6289822602554405
6759,Yemen,YEM,2015,4111654,1289664,175982,1118575,2584221,0.6285112998321357
6760,Yemen,YEM,2004,2961321,918830,122211,771753,1812794,0.6121572095696481
6761,Yemen,YEM,2011,3613071,1141265,154795,978476,2274536,0.6295298376367362
6762,Yemen,YEM,2003,2880030,890048,117830,745366,1753244,0.6087589365388555
6763,Yemen,YEM,2019,4783283,1450889,199761,1273206,2923856,0.611265526208673
6764,Yemen,YEM,2001,2720433,834250,109288,693671,1637209,0.6018192692119233
6765,Yemen,YEM,2000,2641962,807343,105148,668624,1581115,0.5984624305724306
6766,Yemen,YEM,1999,2564643,780778,101106,643660,1525544,0.594836786250562
6767,Yemen,YEM,1998,2487251,754381,97191,619022,1470594,0.5912527525368368
6768,Yemen,YEM,1997,2410985,728276,93415,595471,1417162,0.5877937855274918
6769,Yemen,YEM,1996,2334797,702589,89790,572688,1365067,0.584661964187893
6770,Yemen,YEM,1995,2259001,677448,86327,551168,1314943,0.5820904904424566
6771,Yemen,YEM,1994,2185088,652687,83033,530578,1266298,0.5795180789057466
6772,Yemen,YEM,1993,2111447,628269,79917,510657,1218843,0.5772548399273105
6773,Yemen,YEM,1992,2039743,604336,76974,491847,1173157,0.5751494183335841
6774,Yemen,YEM,1991,1968271,581072,74206,473576,1128854,0.5735256984429482
6775,Yemen,YEM,1990,1898548,558612,71610,456210,1086432,0.572243630395439
6776,Yemen,YEM,2017,4428332,1362281,187536,1189909,2739726,0.6186812551543109
6777,Yemen,YEM,2002,2799105,861834,113520,719417,1694771,0.6054688909490712
6778,Yemen,YEM,2018,4599040,1404415,193548,1229826,2827789,0.614865058794879
6779,Yemen,YEM,2005,3046619,948087,126656,799039,1873782,0.6150365372237224
6780,Zambia,ZMB,1990,778346,245719,34997,223146,503862,0.6473496362800092
6781,Zambia,ZMB,2017,1751295,596177,81345,515695,1193217,0.6813340984814095
6782,Zambia,ZMB,2016,1688946,573614,78260,494869,1146743,0.6789696058962217
6783,Zambia,ZMB,2015,1626587,550788,75258,474532,1100578,0.6766179737081386
6784,Zambia,ZMB,2014,1566089,527424,72334,454407,1054165,0.6731194714987463
6785,Zambia,ZMB,2013,1506720,503258,69498,434302,1007058,0.6683776680471488
6786,Zambia,ZMB,2012,1449465,479571,66752,415005,961328,0.66322953641516
6787,Zambia,ZMB,2011,1395616,457506,64103,397097,918706,0.6582799280031183
6788,Zambia,ZMB,2010,1345396,437984,61547,381008,880539,0.6544831410231634
6789,Zambia,ZMB,2009,1298475,420392,59070,366791,846253,0.6517283736691118
6790,Zambia,ZMB,2008,1254475,403758,56705,353982,814445,0.649231750333805
6791,Zambia,ZMB,2007,1213047,388249,54494,342122,784865,0.6470194477213167
6792,Zambia,ZMB,2006,1173925,373928,52458,331136,757522,0.6452899461209192
6793,Zambia,ZMB,2018,1814633,617610,84517,537202,1239329,0.6829639932702646
6794,Zambia,ZMB,2005,1136258,360639,50585,320418,731642,0.6439048173918247
6795,Zambia,ZMB,2003,1065888,336211,47294,300536,684041,0.6417569200516376
6796,Zambia,ZMB,2002,1034581,325311,45881,291879,663071,0.6409077684589221
6797,Zambia,ZMB,2001,1005855,315491,44611,284049,644151,0.6404014495131007
6798,Zambia,ZMB,2000,979464,306870,43475,277173,627518,0.6406748997410828
6799,Zambia,ZMB,1999,955695,299289,42466,271197,612952,0.64136780039657
6800,Zambia,ZMB,1998,933458,292400,41560,265974,599934,0.6427005821365289
6801,Zambia,ZMB,1997,912571,286059,40728,260979,587766,0.6440770088026028
6802,Zambia,ZMB,1996,892870,280143,39944,256291,576378,0.6455340643094739
6803,Zambia,ZMB,1995,874124,274523,39182,251389,565094,0.6464689220293688
6804,Zambia,ZMB,1994,855820,269000,38416,246361,553777,0.6470718141665304
6805,Zambia,ZMB,1993,837380,263450,37626,241110,542186,0.6474790417731496
6806,Zambia,ZMB,1992,818359,257773,36799,235573,530145,0.6478147121251187
6807,Zambia,ZMB,2004,1099952,348056,48861,310065,706982,0.6427389558817111
6808,Zambia,ZMB,2019,1878016,638038,87777,559699,1285514,0.684506415280807
6809,Zambia,ZMB,1991,798767,251890,35926,229524,517340,0.6476732263601276
6810,Zimbabwe,ZWE,1991,943866,288066,44678,236905,569649,0.6035274074921652
6811,Zimbabwe,ZWE,2018,1424381,428804,68846,380391,878041,0.6164368943421739
6812,Zimbabwe,ZWE,2017,1399346,422440,67403,371659,861502,0.61564616613761
6813,Zimbabwe,ZWE,2016,1374735,414509,66026,363160,843695,0.6137146431857776
6814,Zimbabwe,ZWE,2015,1351088,406668,64713,354911,826292,0.6115752637874069
6815,Zimbabwe,ZWE,2014,1327107,399024,63456,346267,808747,0.6094060237795446
6816,Zimbabwe,ZWE,2013,1303186,391701,62262,336889,790852,0.6068604174691871
6817,Zimbabwe,ZWE,2012,1280474,384815,61146,327649,773610,0.6041590848388956
6818,Zimbabwe,ZWE,2011,1259224,378542,60130,319384,758056,0.6020025031289111
6819,Zimbabwe,ZWE,2010,1240302,373084,59234,313171,745489,0.6010544206169143
6820,Zimbabwe,ZWE,2009,1222284,368597,58463,308860,735920,0.6020859309293094
6821,Zimbabwe,ZWE,2008,1203579,364979,57803,305802,728584,0.6053478832714762
6822,Zimbabwe,ZWE,2007,1185425,361914,57222,303096,722232,0.6092599700529346
6823,Zimbabwe,ZWE,2006,1168775,359185,56703,300535,716423,0.6129691343500674
6824,Zimbabwe,ZWE,2005,1154465,356602,56231,297893,710726,0.6156323491833879
6825,Zimbabwe,ZWE,2004,1141496,354137,55788,294675,704600,0.6172601568468046
6826,Zimbabwe,ZWE,2003,1128900,351835,55352,291204,698391,0.6186473558331119
6827,Zimbabwe,ZWE,2002,1116845,349501,54895,287472,691868,0.6194843510066302
6828,Zimbabwe,ZWE,2001,1106155,346999,54401,283848,685248,0.61948641917272
6829,Zimbabwe,ZWE,2000,1096337,344175,53857,280363,678395,0.61878327558041
6830,Zimbabwe,ZWE,1999,1087080,340638,53241,277522,671401,0.6176187585090334
6831,Zimbabwe,ZWE,1998,1077437,336215,52531,274778,663524,0.6158355430526332
6832,Zimbabwe,ZWE,1997,1066065,331024,51716,271858,654598,0.6140319774122591
6833,Zimbabwe,ZWE,1996,1052033,325243,50796,268187,644226,0.6123629201745573
6834,Zimbabwe,ZWE,1995,1035380,319061,49774,263424,632259,0.6106540593791652
6835,Zimbabwe,ZWE,1994,1015833,312329,48648,257624,618601,0.6089593466642647
6836,Zimbabwe,ZWE,1993,994212,304875,47417,251304,603596,0.6071099524045174
6837,Zimbabwe,ZWE,1992,970060,296762,46090,244343,587195,0.6053182277384904
6838,Zimbabwe,ZWE,2019,1447584,432984,70348,389098,892430,0.6164961756968853
6839,Zimbabwe,ZWE,1990,915527,278995,43213,228871,551079,0.6019254484029417
